Abutilon de Théophraste 	Abutilon theophrasti 	Malvacées
Acacia jaune 	Caragana arborescens 	Fabacées
Acanthe molle 	Acanthus mollis 	Acanthacées
Ache faux-cresson 	Helosciadium nodiflorum 	Apiacées
Ache inondée 	Helosciadium inundatum 	Apiacées
Ache odorante 	Apium graveolens 	Apiaceae
Achillée à feuilles de tanaisie 	Achillea distans subsp. tanacetifolia 	Astéracées
Achillée à grandes feuilles 	Achillea macrophylla 	Astéracées
Achillée millefeuille 	Achillea millefolium 	Astéracées
Achillée musquée 	Achillea erba-rotta subsp. moschata 	Astéracées
Achillée naine 	Achillea nana 	Astéracées
Achillée noirâtre 	Achillea atrata 	Asteracées
Achillée odorante 	Achillea odorata 	Asteracées
Achillée sternutatoire 	Achillea ptarmica 	Astéracées
Achillée tomenteuse 	Achillea tomentosa 	Astéracées
Aconit anthore 	Aconitum anthora 	Renonculacées
Aconit barbu 	Aconitum barbatum 	Renonculacées
Aconit glanduleux 	Aconit glandulosum 	Renonculacées
Aconit napel 	Aconitum napellus 	Renonculacées
Aconit panaché 	Aconitum variegatum 	Renonculacées
Aconit tue-loup 	Aconitum lycoctonum 	Renonculacées
Acore odorant 	Acorus calamus 	Acoracées
Actée en épi 	Actaea spicata 	Renonculacées
Adenostyle à feuilles blanches 	Adenostyle leucophylla 	Asteracées
Adenostyle à feuilles d'alliaire 	Adenostyles alliariae 	Asteracées
Adénostyle des Alpes 	Adenostyles alpina 	Astéracées
Adonis du printemps 	Adonis vernalis 	Renonculacées
Adonis flammé 	Adonis flammea 	Renonculacées
Aeonium noble 	Aeonium nobile 	Crassulacées
Aethionema de Thomas 	Aethionema thomasianum 	Brassicacées
Aethionema des rochers 	Aethionema saxatile 	Brassicaceae
Agapanthe africaine 	Agapanthus africanus 	Amaryllidacées
Agaric à pied laineux 	Agaricus lanipes 	Agaricacées
Agaric anisé des bois 	Agaricus silvicola 	Agaricacées
Agaric bispore 	Agaricus bisporus 	Agaricacées
Agaric des jachères 	Agaricus arvensis 	Agaricacées
Agaric des trottoirs 	Agaricus bitorquis 	Agaricacées
Agaric impérial 	Agaricus augustus 	Agaricacées
Agaric jaunissant 	Agaricus xanthoderma 	Agaricacées
Agaric malodorant 	Agaricus malleolens 	Agaricacées
Agaric ou Psalliote 	Agaricus bisporum 	Agaric des jardins
Agaric radicant 	Agaricus romagnesii 	Agaricacées
Agaric sylvatique 	Agaricus sylvaticus 	Agaricacées
Agrocybe précoce 	Agrocybe praecox 	Bolbitiacées
Agrostide blanche 	Agrostis stolonifera 	Poacées
Agrostide commune 	Agrostis capillaris 	Poacées
Agrostide de Curtis 	Agrostis curtisii 	Poacées
Agrostide de Pourret 	Neoschischkinia pourretii 	Poacées
Agrostide élégante 	Neoschischkinia elegans 	Poacées
Aigremoine eupatoire 	Agrimonia eupatoria 	Rosacées
Aigremoine odorante 	Agrimonia procera 	Rosacées
Ail à fleurs aiguës 	Allium acutiflorum 	Amaryllidacées
Ail à fleurs de narcisse 	Allium narcissiflorum 	Amaryllidacées
Ail à tête ronde 	Allium sphaerocephalon 	Amaryllidacées
Ail à trois angles 	Allium triquetrum 	Amaryllidacées
Ail anguleux 	Allium angulosum L., 1753 	Amaryllidacées
Ail blanc 	Allium neapolitanum 	Amaryllidacées
Ail caréné 	Allium carinatum 	Amaryllidacées
Ail des jardins 	Allium oleraceum 	Amaryllidacées
Ail des ours 	Allium ursinum 	Amaryllidacées
Ail des salines 	Allium savii 	Amaryllidaceae
Ail des victoires 	Allium victorialis 	Amaryllidacées
Ail des vignes 	Allium vineale 	Amaryllidacées
Ail faux-poireau 	Allium ampeloprasum 	Amaryllidacées
Ail noir 	Allium nigrum 	Amaryllidacées
Ail petit moly 	Allium chamaemoly 	Amaryllidacées
Ail raide 	Allium lineare 	Amaryllidacées
Ail rocambole 	Allium scorodoprasum 	Amaryllidacées
Ail rose 	Allium roseum 	Amaryllidacées
Ailante, vernis du Japon 	Ailanthus altissima 	Simaroubacées
Airelle des marais 	Vaccinium uliginosum 	Ericacées
Airelle du mont Ida 	Vaccinium vitis-idaea 	Ericacées
Ajonc à petites fleurs 	Ulex parviflorus 	Fabacées
Ajonc d'Europe 	Ulex europaeus 	Fabacées
Ajonc de Le Gall 	Ulex gallii 	Fabacées
Ajonc nain 	Ulex minor 	Fabacées
Alchémille à cinq folioles 	Alchemilla pentaphyllea 	Rosacées
Alchémille à tige fine 	Alchemilla filicaulis 	Rosacée
Alchémille de Hoppe 	Alchemilla hoppeana 	Rosacées
Alchémille des Alpes 	Alchemilla alpina 	Rosacées
Alchémille vulgaire 	Alchemilla xanthochlora 	Rosacées
Aliboufier 	Styrax officinalis 	Styracacées
Alisier blanc 	Sorbus aria 	Rosacées
Alisier de Fontainebleau 	Sorbus latifolia 	Rosacées
Alisier de Mougeot 	Sorbus mougeotii 	Rosacées
Alisier nain 	Sorbus chamaemespilus 	Rosacées
Alisier torminal 	Sorbus torminalis 	Rosacées
Alkékenge 	Physalis alkekengi 	Solanacées
Alliaire 	Alliaria petiolata 	Brassicacées
Alsine calaminaire 	Minuartia verna var. herycinia 	Caryophyllacées
Althénie de Barrandoni 	Althenia filiformis subsp. barrandonii 	Zanichelliacées
Alysson à feuilles de serpolet 	Alyssum serpyllifolium 	Brassicacées
Alysson des montagnes 	Alyssum montanum 	Brassicacées
Alysson maritime 	Lobularia maritima 	Brassicaceae
Amadouvier 	Fomes fomentarius 	Coriolacée
Amanite argentée 	Amanita argentea 	Amanitacées
Amanite citrine 	Amanita citrina 	Amanitacées
Amanite des césars 	Amanita caesarea 	Amanitacées
Amanite des dunes 	Amanita dunensis 	Amanitaceae
Amanite épaisse 	Amanita spissa 	Amanitacées
Amanite fauve 	Amanita fulva 	Amanitacées
Amanite jaune 	Amanita crocea 	Amanitacées
Amanite jonquille 	Amanita junquillea 	Amanitacées
Amanite livide pâle 	Amanita lividopallescens 	Amanitacées
Amanite ovoïde 	Amanita ovoidea 	Amanitacées
Amanite panthère 	Amanita pantherina 	Agaricales
Amanite phalloïde 	Amanita phalloides 	Amanitacées
Amanite printanière 	Amanita verna 	Amanitacées
Amanite proche 	Amanita proxima 	Amanitacées
Amanite rougissante 	Amanita rubescens 	Amanitacées
Amanite tue-mouches 	Amanita muscaria 	Amanitacées
Amanite vireuse 	Amanita virosa 	Amanitacées
Amarante étalée 	Amaranthus deflexus 	Amaranthacées
Amarante queue de renard 	Amaranthus caudatus 	Amaranthacées
Amarante réfléchie 	Amaranthus retroflexus 	Amaranthacées
Amarcrinum 	Amarcrinum 	Amaryllidacées
Amarinthe 	Prangos trifida 	Apiacées
Ambroisie à feuille d'armoise 	Ambrosia artemisiifolia 	Astéracées
Amélanchier 	Amelanchier ovalis 	Rosacées
Anacardier 	Anacardium occidentale 	Anacardiacées
Anagyre fétide, bois puant 	Anagyris foetida 	Fabacées
Ancolie de Bernard 	Aquilegia bernardii 	Renonculacées
Ancolie de Bertoloni 	Aquilegia bertoloni 	Renonculacées
Ancolie des Alpes 	Aquilegia alpina 	Renonculacées
Ancolie noirâtre 	Aquilegia atrata 	Renonculacées
Ancolie vulgaire 	Aquilegia vulgaris 	Renonculacées
Andromède à feuilles de polium 	Andromeda polifolia 	Ericacées
Androsace à feuilles obtuses 	Androsace obtusifolia 	Primulacées
Androsace couleur de chair 	Androsace carnea 	Primulacées
Androsace des Alpes 	Androsace alpina 	Primulacées
Androsace petit jasmin 	Androsace chamaejasme 	Primulacées
Androsace velue 	Androsace villosa 	Primulacées
Androsème officinale 	Hypericum androsaemum 	Hypéricacées
Andryale à feuilles entières 	Andryala integrifolia 	Asteracées
Anémone à 3 feuilles 	Anemone trifolia 	Ranunculacées
Anémone à fleurs de narcisse 	Anemone narcissiflora 	Renonculacées
Anémone couronnée 	Anémone coronaria 	Renonculacées
Anémone des apennins 	Anemone apennina 	Renonculacées
Anémone des bois 	Anemone nemorosa 	Renonculacées
Anémone des jardins 	Anemone Hortensis 	Renonculacées
Anémone du mont Baldo 	Anemone baldensis 	Renonculacées
Anémone fausse renoncule 	Anemone ranunculoides 	Renonculacées
Anémone hépatique 	Anemone hepatica 	Renonculacées
Anémone palmée 	Anemone palmata 	Ranunculaceae
Anémone pulsatille 	Anemone pulsatilla 	Renonculacées
Aneth 	Anethum graveolens 	Apiacées
Angélique de Razouls 	Angelica razulii 	Apiacées
Angélique sauvage 	Angelica sylvestris 	Apiacées
Angélique vraie 	Angelica archangelica 	Apiacées
Antennaire des Carpates 	Antennaria carpatica 	Astéracées
Antennaire dioïque 	Antennaria dioica 	Astéracées
Anthémis brunâtre 	Chamaemelum fuscatum 	Asteracées
Anthemis de Gérard 	Anthemis cretica subsp. gerardiana 	Asteracées
Anthemis de Trionfetti 	Cota triumfetti 	Astéracées
Anthémis des rochers 	Anthemis cretica subsp. saxatilis 	Asteracées
Anthémis des teinturiers 	Cota tinctoria 	Asteracées
Anthémis maritime 	Anthémis maritima 	Astéracées
Anthémis très élevé 	Cota altissima 	Asteraceae
Anthurus d'archer 	Anthurus archeri 	Clathracées
Anthyllide à fleurs rouges 	Anthyllis vulneraria subsp. praepropera 	Fabaceae
Anthyllide alpestre 	Anthyllis vulneraria subsp. alpestris 	Fabaceae
Anthyllide de Bosc 	Anthyllis vulneraria subsp. boscii 	Fabaceae
Anthyllide des Carpates 	Anthyllis vulneraria subsp. carpatica 	Fabaceae
Anthyllide des montagnes 	Anthyllis montana 	Fabacées
Anthyllide fausse cytise 	Anthyllis cytisoides 	Fabacées
Anthyllide vulnéraire 	Anthyllis vulneraria 	Fabacées
Aphyllanthe de Montpellier 	Aphyllanthes monspeliensis 	Asparagacées
Apocyn à feuilles d'androsème 	Apocynum androsaemifolium 	Apocynacées
Aposeris fétide 	Aposeris foetida 	Astéracées
Arabette à siliques plates 	Arabis planisiliqua 	Brassicaceae
Arabette bleuâtre 	Arabis caerulea 	Brassicacées
Arabette de Thalius 	Arabidopsis thaliana 	Brassicacées
Arabette des Alpes 	Arabis alpina 	Brassicacées
Arabette des sables 	Arabidopsis arenosa 	Brassicacées
Arabette glabre 	Turritis glabra 	Brassicacées
Arabette hérissée 	Arabis hirsuta 	Brassicacées
Arabette printanière 	Arabis verna 	Brassicacées
Arabette subcoriace 	Arabis soyeri ssp subcoriacea 	Brassicacées
Arabette tourette 	Pseudoturritis turrita 	Brassicacées
Araucaria du Chili 	Araucaria araucana 	Araucariacées
Arbousier 	Arbutus unedo 	Ericacées
Arbre à perruque 	Cotinus coggygria 	Anacardiacées
Arbre aux faisans 	Leycesteria formosa 	Caprifoliacées
Arbre aux gentianes 	Solanum rantonnetii 	Solanacées
Arbre aux quarante écus 	Ginkgo biloba 	Ginkgoacées
Arbre de Judée 	Cercis siliquastrum 	Fabacées
Arbre piments 	Ixora margaretae 	Rubiacées
Argemone mexicaine 	Argemone mexicana 	Papavéracées
Argousier 	Hippophae rhamnoides 	Eleagnacées
Argyrolobe de Zanon 	Argyrolobium zanonii 	Fabacées
Aristoloche à feuilles rondes 	Aristolochia rotunda 	Aristolochiaceae
Aristoloche à nervures peu nombreuses 	Aristolochia paucinervis 	Aristolochiaceae
Aristoloche clématite 	Aristolochia clematitis 	Aristolochiacées
Aristoloche pistoloche 	Aristolochia pistolochia 	Arisotolochiacées
Armérie des Alpes 	Statice montana 	Plumbaginacées
Armérie des sables 	Armeria arenaria 	Plumbaginacées
Armerie du Roussillon 	Armeria ruscinonensis Girard 	Plumbaginaceae
Armérie faux buplèvre 	Armeria arenaria subsp. bupleuroides 	Plumbaginaceae
Armillaire couleur de miel 	Armillaria mellea 	Tricholomatacées
Armillaire d'Ostoya 	Armillaria Ostoyae 	Tricholomatacées
Armoise absinthe 	Artemisia absinthium 	Asteraceae
Armoise annuelle 	Artemisia annua 	Astéracées
Armoise commune 	Artemisia vulgaris 	Astéracées
Armoise d'Adams 	Artemisia adamsii 	Astéracées
Armoise insipide 	Artemisia insipida 	Asteraceae
Arnica des montagnes 	Arnica montana 	Astéracées
Arnoséris naine 	Arnoseris minima 	Astéracées
Aronia Noir 	Aronia melanocarpa 	Rosacées
Arroche couchée 	Atriplex prostata 	Chénopodiacées
Arroche étalée 	Atriplex patula 	Chénopodiacées
Arroche maritime 	Atriplex halimus 	Chenopodiacées
Arthonia 		
Arum d'Italie 	Arum italicum 	Aracées
Arum tacheté 	Arum maculatum 	Aracées
Arum d'Italie 	Arum italicum 	Aracées
Arum peint 	Arum pictum 	Aracées
Asaret 	Asarum europaeum 	Aristolochiacées
Asarine couchée 	Asarina procumbens 	Plantaginacées
Asclépiade de Syrie 	Asclepias syriaca 	Asclépiadacées
Ascocoryne sarcoïde 	Ascocoryne sarcoides 	Hélotiacées
Asperge à feuilles épineuses 	Asparagus acutifolius 	Asparagacées
Asperge blanche 	Asparagus albus 	Asparagacées
Asperge officinale 	Asparagus officinalis 	Asparagacées
Aspérule à 6 feuilles 	Asperula hexaphylla 	Rubiacées
Aspérule à l'esquinancie 	Asperula cynanchica 	Rubiacées
Aspérule odorante 	Galium odoratum 	Rubiacées
Asphodèle à petits fruits, asphodèle rameux 	Asphodelus ramosus 	Xanthorrhoeacées
Asphodèle blanc 	Asphodelus albus 	Xanthorrhoeacées
Asphodèle cerise 	Asphodelus cerasiferus 	Xanthorrhoeacées
Asphodèle d'Arrondeau 	Asphodelus macrocarpus arrondeaui 	Xanthorrhoeacées
Asphodèle fistuleuse 	Asphodelus fistulosus 	Xanthorrhoeacées
Asphodeline jaune 	Asphodeline lutea 	Xanthorrhoeacées
Aster à feuilles d'orpin 	Galatella sedifolia 	Astéracées
Aster à feuilles de saule 	Symphyotrichum x salignus 	Astéracées
Aster à feuilles lancéolées 	Symphyotrichum lanceolatum 	Astéracées
Aster amelle 	Aster amellus 	Astéracées
Aster des Alpes 	Aster alpinus 	Astéracées
Aster des Causses 	Aster alpinus subsp. cebennensis 	Asteracées
Aster lynosyris 	Galatella lynosyris 	Astéracées
Aster tripolium 	Tripolium pannonicum 	Astéracées
Astérocarpe faux-sésame 	Sesamoïdes purpurascens 	Résédacées
Asterolide (astérisque) aquatique 	Asteriscus aquaticus 	Asteracées
Astérolide (astérisque) épineux 	Pallenis spinosa 	Astéracées
Astérolide (astérisque) maritime 	Pallenis maritima 	Astéracées
Astéroline en étoile 	Lysimachia linum-stellatum 	Primulacées
Astragale à fleurs pendantes 	Astragalus penduliflorus 	Fabacées
Astragale de Bayonne 	Astragalus baionensis 	Fabacées
Astragale de Montpellier 	Astragalus monspessulanus 	Fabacées
Astragale des Alpes 	Astragalus alpinus 	Fabacées
Astragale des régions froides, des frimas 	Astragalus frigidus 	Fabacées
Astragale du Danemark 	Astragalus danicus 	Fabacées
Astragale en étoile 	Astragalus stella 	Fabacées
Astragale épiglotte 	Biserrula epiglottis 	Fabacées
Astragale faux sainfoin 	Astragalus onobrychis 	Fabacées
Astragale pois-chiche 	Astragalus cicer 	Fabaceae
Astragale pourpre ou hypoglotte 	Astralagus hypoglottis 	Fabacée
Astragale queue de renard 	Astragalus alopecurus 	Fabacées
Astragale toujours verte 	Astragalus sempervirens 	Fabacées
Astragale vésiculeuse 	Astragalus vesicarius 	Fabacées
Astrée hygrométrique 	Astraeus hygrometricus 	Astraeaceae
Atractyle en treillis 	Atractylis cancellata 	Asteracées
Aubépine épineuse 	Crataegus laevigata 	Rosacées
Aubépine monogyne 	Crataegus monogyna 	Rosacées
Aubépine rose 	Crataegus Paul Scarlet 	Rosaceae
Aucuba du Japon 	Aucuba japonica 	Cornacées
Aulne blanc 	Alnus incana 	Bétulacées
Aulne de Corse 	Alnus cordata 	Bétulacées
Aulne glutineux 	Alnus glutinosa 	Bétulacées
Avoine élevée 	Arrhenatherum elatius 	Poacées
Azalée rampante 	Loiseleuria procumbens 	Ericacées
Azalées 	Azalea 	Ericacées
Azolla fausse-fougère 	Azolla filiculoides 	Salviniacées
Azurite 	Echinops ritro 	Astéracées
Azurite à tête globuleuse 	Echinops sphaerocephalus 	Asteracées
Baeomyces 		
Baguenaudier 	Colutea arborescens 	Fabacées
Baldingère faux-roseau 	Phalaris arundinacea 	Poacées
Ballote fétide 	Ballota nigra 	Lamiacées
Ballote sous arbustive 	Ballota frutescens 	Lamiacées
Balsamine à petites fleurs 	Impatiens parviflora 	Balsaminacées
Balsamine de l'Himalaya 	Impatiens glandulifera 	Balsaminacées
Balsamine des bois 	Impatiens noli-tangere 	Balsaminacées
Bananier 	Musa 	Musacées
Barbarée à bractées 	Barbarea bracteosa 	Brassicacées
Barbarée commune 	Barbarea vulgaris 	Brassicacées
Barbarée intermédiaire 	Barbaréa intermedia 	Brassicacées
Barbarée précoce 	Barbarea verna 	Crucifères
Barbe de bouc 	Aruncus dioicus 	Rosacées
Barbe de Jupiter 	Anthyllis barba jovis 	Fabacées
Barbon 	Bothriochloa ischaemum 	Poaceae
Bardane des bois 	Arctium nemorosum 	Astéracées
Bardanette rameuse 	Tragus racemosus 	Poacées
Bartsie des Alpes 	Bartsia alpina 	Orobanchacées
Bartsie visqueuse 	Parentucellia viscosa 	Orobanchacées
Belladone 	Atropa belladonna 	Solanacées
Bellardie 	Bartsia trixago 	Orobanchacées
Belle de jour 	Convolvulus tricolor 	Convolvulacées
Belloperone 	Justicia brandegeeana 	Acanthaceae
Belombra ou raisinier dioïque 	Phytolacca dioica 	Phytolaccacées
Benjoin pays 	Terminalia bentzoë 	Combretacées
Benoîte commune 	Geum urbanum 	Rosacées
Benoîte d'Alep 	Geum aleppicum 	Rosacées
Benoîte des montagnes 	Geum montanum 	Rosacées
Benoîte des ruisseaux 	Geum rivale 	Rosacées
Benoîte rampante 	Geum reptans 	Rosacées
Bérardie laineuse 	Berardia lanuginosa 	Astéracées
Berce du Caucase 	Heracleum mantegazziana 	Apiacées
Berce sphondyle 	Heracleum sphondylium 	Apiacées
Berteroa blanchâtre 	Berteroa incana 	Brassicacées
Bétoine officinale 	Betonica officinalis 	Lamiacées
Bident bipenné 	Bidens bipinnata 	Astéracées
Bident conné 	Bidens connata 	Astéracées
Bident feuillé 	Bidens frondosa 	Astéracées
Bident penché 	Bidens cernua 	Astéracées
Bident poilu 	Bidens pilosa 	Astéracées
Bident radié 	Bidens radiata 	Astéracées
Bident tripartite 	Bidens tripartita 	Astéracées
Bifora à testicules 	Bifora testiculata 	Apiaceae
Bifora rayonnant, sudeur 	Bifora radians 	Apiaceae (Ombellifères)
Bignone 	Campsis radicans 	Bignonacées
Biscutelle à feuilles courtes 	Biscutella brevifolia 	Brassicacées
Biscutelle à feuilles de chicorée 	Biscutella cichoriifolia 	Brassicaceae
Biscutelle d'Auvergne 	Biscutella arvernensis 	Brassicaceae
Biscutelle lisse ou lunetière 	Biscutella laevigata 	Brassicacées
Biserrule à deux scies 	Biserrula pelecinus 	Fabacées
Blechne en épi 	Blechnum spicant 	Blechnacées
Blétilla 	Bletilla striata 	Orchidacées
Bois de rennes 		
Bois de tension 	Pouzolzia laevigata 	Urticacées
Bois joli 	Daphne mezereum 	Thyméléacées
Bolbitie multicolore 	Bolbitia variicolor 	Bolbitiaceae
Bolbitis lonchophora 	Bolbitis lonchophora 	Dryopteridacées
Bolet à beau pied 	Boletus calopus 	Boletacées
Bolet à pied creux 	Boletinus ou Suillus cavipes 	Gyrodontacées
Bolet à pied rouge 	Boletus erythropus 	Boletacées
Bolet amer 	Tylopilus felleus 	Boletacées
Bolet bai 	Xerocomus badius 	Boletacées
Bolet blafard 	Boletus luridus 	Boletacées
Bolet de quélet 	Boletus queletii 	Boletacées
Bolet des bouviers 	Suillus bovinus 	Boletacées
Bolet faux royal 	Boletus pseudoregius 	Boletacées
Bolet indigotier 	Gyroporus cyanescens 	Boletacées
Bolet orangé 	Leccinum albostipitatum 	Boletacées
Bolet parasite 	Xerocomus parasiticus 	Boletacées
Bolet poivré 	Chalciporus piperatus 	Boletacées
Bolet pomme de pin 	Strobilomyces flocopus 	Boletacées
Bolet radicant 	Boletus radicans 	Boletacées
Bolet rose pourpre 	Boletus rhodopurpureus 	Boletacées
Bolet rude 	Leccinum scabrum 	Boletacées
Bolet rude des charmes 	Leccinum carpini 	Boletacées
Bolet rude des trembles 	Leccinum duriusculum 	Boletacées
Bolet satan 	Boletus satanas 	Boletacées
Bonjeanie hirsute 	Dorycnium hirsutum 	Fabacées
Botryche lunaire 	Botrychium lunaria 	Ophioglossacées
Boucage rouge 	Pimpinella major var. rubra 	Apiacées
Bougainvillier ou bougainvillée 	Bougainvillea 	Nyctaginacées
Bouleau des Carpathes 	Betula pubescens subsp. glabratus 	Betulacées
Bouleau nain 	Betula nana 	Bétulacées
Bouleau Pleureur 	Betula pendula 'Tristis' 	Betulaceae
Bouleau pubescent 	Betula pubescens 	Bétulacées
Bouleau verruqueux 	Betula pendula 	Bétulacées
Bourdaine 	Frangula alnus 	Rhamnacées
Bourrache officinale 	Borago officinalis 	Boraginacées
Bourse à pasteur 	Capsella bursa-pastoris 	Brassicacées
Boviste plombée 	Bovista plumbea 	Lycoperdacées
Brachypode des bois 	Brachypodium sylvatica 	Poacées
Brachypode penné 	Brachypodium pinnatum 	Poacées
Brize moyenne 	Briza media 	Poacées
Brome mou 	Bromus hordaceus 	Poacées
Brome rameux 	Bromus ramosus 	Poacées
Brome rouge 	Bromus rubens 	Poacées
Brome stérile 	Bromus sterilis 	Graminées
Brugmansia 	Brugmansia 	Solanacées
Brunelle à grandes fleurs 	Prunella grandiflora 	Lamiacées
Brunelle commune 	Prunella vulgaris 	Lamiacées
Brunelle laciniée 	Prunella laciniata 	Lamiacées
Bruyère à nombreuses fleurs 	Erica multiflora 	Ericacées
Bruyère à quatre angles 	Erica tetralix 	Ericacées
Bruyère arborescente 	Erica arborea 	Ericacées
Bruyère carnée 	Erica carnea 	Ericaceae
Bruyère cendrée 	Erica cinerea 	Ericacées
Bruyère ciliée 	Erica ciliaris 	Ericacées
Bruyère de Watson 	Erica x watsonii 	Ericacées
Bruyère herbacée ou carnée 	Erica herbacea 	Ericaceae
Bruyère vagabonde 	Erica vagans 	Ericacées
Bryone dioïque 	Bryonia dioica 	Cucurbitacées
Bryone marbrée 	Bryonia marmorata 	Cucurbitacées
Buddleia ou arbre aux papillons 	Buddleia davidii 	Loganiacées
Bugle de Genève 	Ajuga genevensis 	Lamiacées
Bugle ivette 	Ajuga iva 	Lamiacées
Bugle petit-pin 	Ajuga chamaepitys 	Lamiacées
Bugle pyramidal 	Ajuga pyramidalis 	Lamiacées
Bugle rampant 	Ajuga reptans 	Lamiacées
Buglosse azurée 	Anchusa azurea 	Boraginacées
Buglosse des champs 	Anchusa arvensis 	Boraginacées
Buglosse leptophylle 	Anchusa leptophylla subsp. incana 	Boraginacées
Buglosse officinale 	Anchusa officinalis 	Boraginacées
Buglosse toujours verte 	Pentaglottis sempervirens 	Boraginacées
Bugrane à feuilles rondes 	Ononis rotundifolia 	Fabacées
Bugrane buissonnante 	Ononis fruticosa 	Fabacées
Bugrane épineuse 	Ononis spinosa subsp. spinosa 	Fabacées
Bugrane jaune ou coqcigrue 	Ononis natrix 	Fabacées
Bugrane naine 	Ononis pusilla 	Fabacées
Bugrane pied d'oiseau 	Ononis ornithopodioides 	Fabacées
Bugrane rampante 	Ononis spinosa subsp. procurrens 	Fabacées
Bugrane striée 	Ononis striata 	Fabacées
Bugrane très grêle 	Ononis minutissima 	Fabacées
Buis 	Buxus sempervirens 	Buxacées
Buisson ardent 	Pyracantha coccinea 	Rosacées
Bulgarie pure 	Neobulgaria pura 	Leotiacées
Buphtalme à feuilles de saule 	Buphtalmum salicifolium 	Astéracées
Buplèvre à feuilles de jonc 	Bupleurum praealtum 	Apiacées
Buplèvre à longues feuilles 	Bupleurum longifolium 	Apiacées
Buplèvre en faux 	Bupleurum falcatum 	Apiacées
Buplèvre étoilé 	Bupleurum stellatum 	Apiacées
Buplèvre ligneux 	Bupleurum fructicosum 	Apiacées
Cactus de Noël 	Schlumbergera truncata 	Cactacées
Cakilier maritime 	Cakile maritima 	Brassicacées
Calament à feuilles de menthe 	Clinopodium nepeta subsp. sylvaticum 	Lamiacées
Calament à grandes fleurs 	Clinopodium grandiflorum 	Lamiacées
Calament ascendant 	Clinopodium nepeta subsp. ascendens 	Lamiacées
Calament clinopode 	Clinopodium vulgare 	Lamiacées
Calament des Alpes 	Clinipodium alpinum 	Lamiacées
Calament des champs 	Clinopodium acinos 	Lamiacées
Calicotome épineux 	Cytisus spinosus 	Fabacées
Calla des marais 	Calla palustris 	Aracées
Callune fausse bruyère 	Calluna vulgaris 	Ericacées
Calocère visqueuse 	Calocera viscosa 	Caloceracées
Caloplaca 		
Calopogon tubéreux 	Calopogon tuberosus 	Orchidacées
Calypso bulbeuse 	Calypso bulbosa 	Orchidacées
Camarine noire 	Empetrum nigrum 	Empetracées
Camassie de Cusick 	Camassia cusickii 	Hyacinthacées
Camélée à trois coques 	Cneorum tricoccon 	Rutacées
Cameline à petits fruits (sylvestre) 	Camelina microcarpa subsp. sylvestris 	Brassicacées
Camérisier à balais 	Lonicera xylosteum 	Caprifoliacées
Camérisier des Alpes 	Lonicera alpigena 	Caprifoliacées
Camérisier noir 	Lonicera nigra 	Caprifoliacées
Camomille odorante 	Chamomilla suaveolens 	Astéracées
Camomille puante 	Anthemis cotula 	Astéracées
Camomille romaine 	Chamaemelum nobile 	Astéracées
Camomille sauvage 	Matricaria recrutita 	Astéracées
Campanule à corolle étroite 	Campanula stenocodon 	Campanulaceae
Campanule à feuille de Cochléaire 	Campanula cochleariifolia 	Campanulaceae
Campanule à feuille de pêcher 	Campanula persicifolia 	Campanulacées
Campanule à feuilles en losange 	Campanula rhomboidalis 	Campanulacées
Campanule à feuilles rondes 	Campanula rotundifolia 	Campanulacées
Campanule à larges feuilles 	Campanula latifolia 	Campanulacées
Campanule à petites fleurs 	Campanula erinus 	Campanulaceae
Campanule agglomérée 	Campanula glomerata 	Campanulacées
Campanule alpestre 	Campanula alpestris 	Campanulacées
Campanule barbue 	Campanula barbata 	Campanulacées
Campanule corse 	Campanula corsica 	Campanulacées
Campanule de Scheuchzer 	Campanula scheuchzrei 	Campanulacées
Campanule des Alpes 	Campanula alpestris All. 	CAMPANULACEES
Campanule des Carpates 	Campanula carpatica 	Campanulaceae
Campanule du mont Cenis 	Campanula Cenisia 	Campanulacées
Campanule en épi 	Campanula spicata 	Campanulacées
Campanule en lyre 	Campanula lyrata 	Campanulacées
Campanule en thyrse 	Campanula thyrsoides 	CAMPANULACEES
Campanule étalée 	Campanula patula 	Campanulacées
Campanule fausse ficaire 	Campanula scheuzeri subsp. ficaroides 	Campanulacées
Campanule fausse raiponce 	Campanula rapunculoides 	Campanulacées
Campanule gantelée 	Campanula trachelium 	Campanulacées
Campanule raiponce 	Campanula rapunculus 	Campanulacées
Campanule tomenteuse 	Campanula vardariana = C. tomentosa 	Campanulacées
Canche caryophyllée 	Aira caryophyllea 	Poacées
Canche cespiteuse 	Deschampsia cespitosa 	Poacées
Canche de Provence 	Aira provincialis 	Poaceae
Canche des marais 	Deschampsia setacea 	Poacées
Canche printanière 	Aira praecox 	Graminées
Candellariella 		
Canne de Provence 	Arundo donax "variegata" 	Poacées
Canneberge 	Vaccinium oxycoccos 	Ericacées
Capillaire 	Asplenium trichomanes 	Aspléniacées
Capillaire de Jahandiez 	Asplenium jahandiezi 	Aspleniaceae
Capillaire de Montpellier 	Adiantum capillus-veneris 	Ptéridacées
Capillaire de Pétrarque 	Asplenium petrarchae 	Aspleniacées
Capillaire des sources 	Asplenium fontanum 	Aspléniacées
Capillaire fendu 	Asplenium fissum 	Aspleniaceae
Capillaire lancéolée 	Asplenium obovatum lanceolatum 	Aspleniacées
Capillaire noir 	Asplenium adiantum-nigrum 	Aspléniacées
Capillaire noire 	Asplenium adiantum-nigrum 	Aspleniaceae
Capillaire vert 	Asplenium viride 	Aspléniacées
Câprier commun 	Capparis spinosa 	Capparacées
Capselle rougeâtre 	Capsella rubella 	Crucifères
Capuchon de moine 	Arisarum vulgare 	Aracées
Capucine 	Tropaeolum majus 	Tropaéolacée
Cardamine à bulbilles 	Cardamine bulbifera 	cardaminaceae
Cardamine à feuilles épaisses 	Cardamine crassifolia 	Brassicaceae
Cardamine à larges feuilles 	Cardamine raphanifolia 	Brassicacées
Cardamine amère 	Cardamine amara 	Brassicacées
Cardamine des prés 	Cardamine pratensis 	Brassicacées
Cardamine flexueuse 	Cardamine flexuosa 	Brassicacées
Cardamine hirsute 	Cardamine hirsuta 	Brassicacées
Cardamine impatiente 	Cardamine impatiens 	Brassicacées
Cardère féroce 	Dipsacus ferox 	Caprifoliaceae
Cardère sauvage 	Dipsacus fullonum 	Dipsacacées
Cardère velue 	Dipsacus pilosus 	Dipsacacées
Cardoncelle molle 	Carduncellus mitissimus 	Astéracées
Carissa macrocarpa 	Carissa macrocarpa 	Apocynacées
Carline à feuilles d'Acanthe 	Carlina acanthifolia 	Astéracées
Carline acaule 	Carlina acaulis 	Astéracées
Carline caulescente 	Carlina acaulis subsp. caulescens 	Asteraceae
Carline commune 	Carlina vulgaris 	Asteraceae
Carotte sauvage 	Daucus carota 	Apiacées
Caroubier 	Ceratonia siliqua 	Fabacées
Carthame des teinturiers 	Carthamus tinctorius 	Astéracées
Carvi 	Carum carvi 	Apiacées
Carvi verticillé 	Carum verticillatum 	Apiacées
Caryopteris 	Caryopteris 	Verbenacées
Cassis 	Ribes nigrum 	Grossulariacées
Catalpa 	Catalpa bignonioïdes walter 	Bignoniacée
Catananche bleue 	Catananche caerulea 	Astéracées
Céanothe 	Ceanothus impressus 	Rhamnacées
Cèdre de Chypre 	Cedrus hevifolia 	PINACEES
Cèdre de l'Atlas 	Cedrus atlantica 	Pinacées
Cèdre du japon nain "Vilmoriana gold" 	Cryptomeria japonica "Vilmoriana gold" 	Taxodiaceae
Cèdre du Liban 	Cedrus libani 	Pinaceae
Centaurée alpestre 	Centaurea alpestris 	Asréraceae
Centaurée à feuilles étroites 	Centaurea jacea L. subsp. angustifolia 	Astéraceae
Centaurée Alpestre 	Centaurea alpestris 	Asteraceae
Centaurée bleuet 	Cyanus segetum 	Astéracées
Centaurée chausse-trape 	Centaurea calcitrapa 	Astéracées
Centaurée d'Émilie 	Centaurea jordaniana aemilii 	Asteraceae
Centaurée de Gaudin 	Centaurea jacea subsp. gaudinii 	Asteraceae
Centaurée de Hongrie 	Centaurea pannonica subsp. pannonica 	Asteraceae
Centaurée de Timbal-Lagrave 	Centaurea jacea subsp. timbalii 	Asteraceae
Centaurée de Verguin 	Centaurea balbisiana subsp. verguinii 	Asteracées
Centaurée des collines 	Centaurea collina 	Astéracées
Centaurée des montagnes 	Cyanus montanus 	Astéracées
Centaurée du Rhin 	Centaurea stoebe 	Astéracée
Centaurée en panicule 	Centaurea paniculata 	Astéracées
Centaurée en peigne 	Centaurea pectinata 	Asteraceae
Centaurée fausse chicorée 	Cheirolophus intybaceus 	Asteraceae
Centaurée Gris clair 	Centaurée leucophaea 	Astéraceae
Centaurée jacée 	Centaurea jacea 	Astéracées
Centaurée noire 	Centaurea nigra 	Astéracées
Centaurée pâle 	Centaurea paniculata subsp. leucophaea 	Asteraceae
Centaurée presque bleue 	Centaurea pseudocaerulescens 	Asteracées
Centaurée rude 	Centaurea aspera 	Astéracées
Centaurée scabieuse 	Centaurea scabiosa 	Astéracées
Centaurée tardive 	Centaurea decipiens 	Asteraceae
Centaurée uniflore 	Centaurea uniflora 	Astéracées
Centranthe chausse-trappe 	Centranthus calcitrapae 	Valérianacées
Centranthe rouge 	Centranthus ruber 	Valérianacées
Cèpe bronzé 	Boletus aereus 	Boletacées
Cèpe d'été 	Boletus oestivalis 	Boletacées
Cèpe de Bordeaux 	Boletus edulis 	Boletacées
Cèpe des pins 	Boletus pinophilus 	Boletacées
Céphalaire à fleurs blanches 	Cephalaria leucantha 	Dipsacacées
Céphalaire de Transylvanie 	Cephalaria transylvanica 	Dipsacaceae
Céphalaire des Alpes 	Cephalaria alpina 	Caprifoliaceae
Céphalanthère à feuilles en épée 	Cephalanthera longifolia 	Orchidacées
Céphalanthère à grandes fleurs 	Cephalanthera damasonium 	Orchidacées
Céphalanthère rouge 	Cephalanthera rubra 	Orchidacées
Céraiste à feuilles larges 	Cerastium latifolium 	Caryophyllacées
Céraiste à une fleur 	Cerastium uniflorum 	Caryophyllacées
Céraiste aggloméré 	Cerastium glomeratum 	Caryophyllacée
Céraiste commun 	Cerastium fontanum 	Caryophyllacées
Céraiste cotonneux 	Cerastium tomentosum 	Caryophyllaceae
Céraiste de Sicile 	Cerastium siculum 	Caryophyllaceae
Céraiste de Soleirol 	Cerastium soleirolii 	Caryophyllacées
Céraiste des champs 	Cerastium arvense 	Caryophyllacées
Céraiste dressé 	Moenchia erecta 	Caryophyllacées
Céraiste naine 	Cerastium pumilum 	Caryophyllaceae
Céraiste vulgaire 	Cerastium vulgatum, 	Caryophyllacées
Cératocéphale en faux 	Ceratocephalus falcatus 	Ranunculaceae
Cerfeuil anisé 	Myrrhis odorata 	Apiacées
Cerfeuil des Alpes 	Meum athamanticum 	Apiacées
Cerfeuil doré 	Chaerophyllum aureum 	Apiacées
Cerfeuil enivrant 	Chaerophyllum temulum 	Apiacées
Cerfeuil noueux 	Chaerophyllum nodosum 	Apiacées
Cerinthe major 	Cerinthe major 	Boraginacées
Cerisier à grappes 	Prunus padus 	Rosacées
Cerisier de Sainte Lucie 	Prunus mahaleb 	Rosacées
Cerisier tardif 	Prunus serotina 	Rosacées
Cétérach 	Asplenium ceterach 	Aspléniacées
Chalef 	Elaeagnus angustifolia 	Elaeagnacées
Chalef de ebbing 	Eleagnus x ebbingei 	Eleagnacées
Chanterelle améthyste ou Girolle améthyste 	Cantharellus amethysteus 	Cantharellaceae
Chanterelle en tube 	Cantharellus tuboeformis 	Cantharellacées
Chanterelle violette 	Gomphus clavatus 	Gomphacées
Chardon à bractées larges 	Carduus nutans subsp. platylepis 	Asteraceae
Chardon à capitules denses 	Carduus pycnocephalus 	Astéracées
Chardon à feuilles de carline 	Carduus carlinifolius 	Astéracées
Chardon à fleurs en tête 	Carduus cephalanthus 	Asteraceae
Chardon aux ânes 	Onopordium acanthium 	Astéracées
Chardon bardane 	Carduus personata 	Astéracées
Chardon bénit 	Cnicus benedictus 	Astéracées
Chardon bleu des Pyrénées 	Eryngnium bourgatii 	Apiacées
Chardon d'Espagne 	Cynara cardunculus 	Astéracées
Chardon de Casabona 	Ptilostemon casabonae 	Astéracées
Chardon décapité 	Carduus defloratus 	Astéracées
Chardon du Vivarais 	Carduus nigrescens subsp. vivariensis 	Asteraceae
Chardon faux gnaphale 	Ptilostemon gnaphaloide 	Asteraceae
Chardon Faux-Acanthe 	Carduus acanthoides 	Astéracées
Chardon laiteux 	Galactites tomentosa 	Astéracées
Chardon Marie 	Silybum marianum 	Astéracées
Chardon noircissant 	Carduus nigrescens 	Astéracées
Chardon penché 	Carduus nutans 	Astéracées
Charme 	Carpinus betulus 	Corylacées
Châtaignier 	Castanea sativa 	Fagacées
Cheilanthes de Madère 	Cheilanthes maderensis 	Pteridacées
Chélidoine 	Chelidonium majus 	Papavéracées
Chêne du Mont Tabor 	Quercus ithaburensis 	Fagacées
Chêne faux-liège 	Quercus crenata 	Fagaceae
Chêne kermès 	Quercus coccifera 	Fagacées
Chêne liège 	Quercus suber 	Fagacées
Chêne pédonculé 	Quercus robur 	Fagacées
Chêne pubescent 	Quercus pubescens 	Fagacées
Chêne rouge 	Quercus rubra 	Fagacées
Chêne sessile 	Quercus petraea 	Fagacées
Chêne tauzin 	Quercus pyrenaica 	Fagacées
Chêne vert 	Quercus ilex 	Fagacées
Chenette 	Dryas octopetala 	Rosacées
Chenillette 	Scorpiurus muricatus 	Fabacées
Chénopode blanc 	Chenopodium album 	Chénopodiacées
Chénopode Bon-Henri 	Chenopodium bonus-henricus 	Chénopodiacées
Chénopode polysperme 	Chenopodium polyspermum 	Chénopodiacées
Chénopode rouge 	Chenopodium rubrum 	Chénopodiacées
chevrefeuille d'Alaska 	lonicera involucrata 	caprifoliaceae
Chèvrefeuille d'Etrurie 	Lonicera etrusca 	Caprifoliacées
Chèvrefeuille des Baléares 	Lonicera implexa 	Caprifoliacées
Chèvrefeuille des bois 	Lonicera periclymenum 	Caprifoliacées
Chèvrefeuille du Japon 	Lonicera japonica 	Caprifoliacées
Chicorée sauvage 	Cichorium intybus 	Astéracées
Chiendent pied-de-poule 	Cynodon dactylon 	Poacées
Chlore ou blackstonie perfoliée 	Blackstonia perfoliata 	Gentianacées
Choin ferrugineux 	Schoenus ferrugineus 	Cyperaceae
Chondrille à tiges de jonc 	Chondrilla juncea 	Astéracées
Chou des champs 	Moricandia arvensis 	Brassicacées
Chou des montagnes 	Brassica montana 	Brassicaceae
Chou étalé 	Brassica repanda 	Brassicacées
Chou marin 	Crambe maritima 	Cruciféracées
Chrysanthème couronné 	Glebionis coronaria 	Astéracées
Chrysanthème des moissons 	Chrysanthemum segetum 	Astéracées
Ciboulette 	Allium schoenoprasum 	Liliacées
Cicendie filiforme 	Cicendia filiformis 	Gentianacées
Cicerbite des Alpes 	Cicerbita alpina 	Astéracées
Cigüe aquatique 	Cicuta virosa 	Ombellifère
Cinéraire maritime 	Jacobaea maritima 	Astéracées
Circée de Paris 	Circaea lutetiana 	Onagracées
Circée des Alpes 	Circaea alpina 	Onagraceae
Cirse acarna 	Picnomon acarna (L.) Cass. 1826 	Asteraceae
Cirse acaule 	Cirsium acaule 	Astéracées
Cirse d'Angleterre 	Cirsium anglicum 	Astéracées
Cirse de Montpellier 	Cirsium monspessulanum 	Astéracées
Cirse de Moris 	Cirsium morisianum 	Astérac
Cirse des champs 	Cirsium arvense 	Astéracées
Cirse des marais 	Cirsium palustre 	Astéracées
Cirse des montagnes 	Cirsium montanum 	Astéracées
Cirse des ruisseaux 	Cirsium rivale 	Astéracées
Cirse épineux 	Cirsium spinosissimum 	Astéracées
Cirse féroce 	Cirsium ferox 	Astéraceae
Cirse glutineux 	Cirsium erisithales 	Astéracées
Cirse laineux 	Cirsium eriophorum 	Astéracées
Cirse lancéolé 	Cirsium vulgare 	Astéracées
Cirse maraîcher 	Cirsium oleraceum 	Astéracées
Cirse tubéreux 	Cirsium tuberosum (L.) All., 1785 	Asteraceae
Ciste à feuilles de laurier 	Cistus laurifolius 	Cistaceaee
Ciste à feuilles de peuplier 	Cistus populifolius 	Cistacées
Ciste à feuilles de sauge 	Cistus salvifolius 	Cistacées
Ciste cotonneux 	Cistus albidus 	Cistacées
Ciste crépu 	Cistus crispus 	Cistaceae
Ciste de Crète 	Cistus creticus 	Cistacées
Ciste de Montpellier 	Cistus monspeliensis 	Cistacées
Ciste du Liban 	Cistus libanotis 	Cistacées
Ciste ladanifère 	Cistus ladaniferus 	Cistacées
Citronnier 	Citrus limon 	Rutacées
Citronnier épineux 	Poncirus trifoliata 	Rutacées
CJeistogène tardif 	Cleistogenes serotina 	Poaceae
Cladonia 		
Clathre rouge 	Clathrus cancellatus 	Clatracées
Clavaire crépue 	Sparassis crispa 	Sparassidacées
Clavaire en pilon 	Clavariadelphus pistillaris 	Clavariadelphacées
Claytonie perfoliée 	Claytonia perfoliata 	Portulacacées
Clématite des alpes 	Clematis alpina 	Renonculacées
Clématite des haies 	Clematis vitalba 	Renonculacées
Clématite droite 	Clematis recta 	Ranunculaceae
Clématite flammette 	Clematis flammula 	Renonculacées
Clérodendron inerme 	Clerodendrum inerme 	Verbenaceae
Clitocybe géotrope 	Clitocybe geotropa 	Tricholomatacées
Clitocybe inversé 	Lepista inversa 	Tricholomatacées
Clitocybe nébuleux 	Lepista nebularis 	Tricholomatacées
Clitocybe odorant 	Clitocybe odora 	Tricholomatacées
Clitocybe orangé 	Hygrophoropsis aurantiaca 	Hygrophoropsidacées
Clitopile petite prune 	Clitopilus prunulus 	Entolomacées
Clypéole 	Clypeola jonthlaspi 	Brassicaceae
Cocculus à feuilles de laurier 	Cocculus laurifolius 	Menispermacées
Cognassier 	Cydonia oblonga ou Cydonia vulgaris 	Rosacées
Cognassier du Japon 	Chaenomeles japonica 	Rosacées
Colchique alpine 	Colchicum alpinum 	Liliaceae
Colchique d'automne 	Colchicum autumnale 	Liliacées
Colchique de printemps 	Bulbocodium vernum 	Liliacées
Colchique des Pyrénées 	Merendera Montana 	Liliacée
Coléanthe délicat 	Coleanthus subtilis 	Poacées
Collomie à grandes fleurs 	Collomia grandiflora 	Polémoniacées
Collybie à lames larges 	Megacollybia platyphylla 	Marasmiacées
Collybie à pied en fuseau 	Collybia fusipes 	Marasmiacées
Collybie à pied velouté 	Flammulina velutipes 	Dermolomatacées
Collybie beurrée 	Collybia butyracea 	Marasmiacées
Collybie guêtrée 	Collybia peronata 	Marasmiacées
Comaret 	Potentilla palustris 	Rosacées
Commeline 	Commelina diffusa 	Commelinacées
Compagnon blanc 	Silene alba 	Caryophyllacées
Concombre d'âne 	Ecballium elaterium 	Cucurbitacées
Conopode dénudé 	Conopodium majus 	Apiacées
Consoude bulbeuse 	Symphytum bulbosum 	Boraginacées
Consoude officinale 	Symphytum officinale 	Boraginacées
Consoude tubéreuse 	Symphytum tuberosum 	Boraginacées
Copalme d Amérique 	Liquidambar styracyflua 	Hamamelidacées
Coprin chevelu 	Coprinus comatus 	Agaricacées
Coprin des forêts 	Coprinus silvaticus 	Coprinacées
Coprin noir d'encre 	Coprinus atramentarius 	Coprinacées
Coquelicot 	Papaver rhoeas 	Papavéracées
Coquelicot douteux 	Papaver dubium 	Papaveraceae
Coquelicot hybride (Pavot hybride) 	Papaver hybridum 	Papavéracées
Coquelourde des jardins 	Silene coronaria 	Caryophyllaceae
Corète du Japon 	Kerria Japonica 	Arbuste à fleurs
Coris de Montpellier 	Coris monspeliensis 	Primulacée
Cormier 	Sorbus domestica 	Rosacées
Cornifle nageant 	Ceratophyllum demersum 	Cératophyllacées
Cornouiller à fleur Américain 	Cornus florida 	Cornacées
Cornouiller du Canada 	Cornus canadensis 	Cornacées
Cornouiller mâle 	Cornus mas 	Cornacées
Cornouiller sanguin 	Cornus sanguinea 	Cornacées
Corokia cotoneaster Raoul 	Corokia cotoneaster Raoul 	Escalloniaceae
Coronille à feuilles de jonc 	Coronilla juncea 	Fabacées
Coronille arbrisseau 	Hippocrepis emerus (L.) Lassen 	Fabaceae
Coronille bigarrée 	Coronilla varia 	Fabacées
Coronille de Valence 	Coronilla valentina 	Fabacées
Coronille en couronne 	Coronilla coronata 	Fabacées
Coronille engainante 	Coronilla vaginalis 	Fabacées
Coronille faux lotier 	Coronilla minima subsp. lotoide 	Fabaceae
Coronille glauque 	Coronilla valentina ssp glauca 	Fabacées
Coronille naine 	Coronilla minima 	Fabaceae
Corrigiole des grèves 	Corrigiola littoralis 	Caryophyllacées
Cortinaire couleur de roucou 	Cortinarius orellanus 	Cortinariacées
Cortinaire irrégulier 	Cortinarius anomalus 	Cortinariacées
Cortinaire large 	Cortinarius largus 	Cortinariacées
Cortinaire parfumé 	Cortinarius odorifer 	Cortinariacées
Cortinaire remarquable 	Cortinarius proestans 	Cortinariacées
Cortinaire rougeâtre 	Cortinarius bolaris 	Cortinariacées
Cortinaire violet 	Cortinarius violaceus 	Cortinariacées
Corydale à 9 folioles 	Corydalis enneaphylla 	Fumariacées
Corydale à vrilles 	Corydalis claviculata 	Fumariacées
Corydale creuse 	Corydalis bulbosa 	Fumariacées
Corydale de lait 	Corydalis ochroleucas 	Papaveraceae
Corydale jaune 	Pseudofumaria lutea 	Fumariacées
Corydale solide 	Corydalis solida 	Fumariacées
Corylopsis 	Corylopsis 	Hamamélidacées
Cotonéaster commun 	Cotoneaster integerrimus 	Rosacées
Cotonéaster tomenteux 	Cotoneaster tomentosa 	Rosacées
Cotonière commune 	Filago vulgaris 	Asteraceae
Cotonnière à feuilles spatulées 	Filago pyramidata 	Asteraceae
Cotonnière naine 	Logfia minima 	Astéracées
Coulemelle 	Macrolepiota procera 	Agaricacées
Cranson d'Angleterre 	Cochlearia anglica 	Brassicacées
Cranson danois 	Cochlearia danica 	Brassicacées
Crapaudine à feuilles d'hysope 	Sideritis hyssopifolia 	Lamiacées
Crassule de Helm 	Crassula helmsii 	Crassulacée
Crassule de Vaillant 	Crassula vaillantii 	Crassulaceae
Crépide à feuilles de Pissenlit 	Crepis vesicaria 	Astéracées
Crépide bisannuelle 	Crepis biennis 	Asteraceae
Crépide bisanuelle 	Crepis biennis 	Asteraceae
Crépide ciliée 	Crepis setosa 	Astéracées
Crépide des Pyrénées 	Crepis pyrenaica 	Asteraceae
Crépide orangée 	Crepis aurea 	Astéracées
Crépide verdâtre 	Crepis capillaris 	Astéracées
Crépis des marais 	Crepis paludosa 	Astéracées
Crépis élégant 	Crepis pulchra 	Astéracées
Crepis faux lampsane 	Crepis lampsanoides 	Asteracées
Crépis faux liondent 	Crepis leontodoides 	Asteraceae
Crépis saint /Erba rossa 	Crepis sancta 	Asteraceae
Cresson de fontaine 	Nasturtium officinale 	Brassicacées
Crételle 	Cynosurus cristatus 	Poacées
Criste marine 	Crithmum maritimum 	Apiacées
Crocosmia 	Crocosmia 	Iridacées
Crocus à couleurs variables 	Crocus versicolor 	Iridaceae
Crocus à fleur nue 	Crocus nudiflorus 	Iridacées
Crocus à fleurs blanches 	Crocus albiflorus 	Iridacées
Crocus d'automne 	Sternbergia lutea 	Liliacées
Crocus de Corse 	Crocus corsicus 	Iridaceae
Crocus de Ligurie 	Crocus ligusticus 	Iridacées
Crocus printanier 	Crocus vernus 	Iridacées
Crupine commune 	Crupina vulgaris 	Astéracées
Cucubale à baies 	Cucubalus baccifer 	Caryophyllacées
Cumin cornu 	Hypecoum procumbens 	Papavéracées
Curcuma 	Curcuma longa 	Zingibéracées
Cuscute du thym 	Cuscuta epithymum 	Convolvulaceae
Cyathe strié 	Cyathus striatus 	Nidulariacées
Cyclamen 	Cyclamen Purpurascens 	Primulacées
Cyclamen à feuilles de lierre 	Cyclamen hederifolium 	Primulaceae
Cyclamen étalé 	Cyclamen repandum 	Primulaceae
Cymbalaire à feuilles d'hépatique 	Cymbalaria hepaticifolia 	Scrophulariacées
Cynoglosse à feuilles de giroflée 	Parnoglossum cheirifolium 	Boraginacées
Cynoglosse de Crète 	Cynoglossum creticum 	Boraginacées
Cynoglosse officinal 	Cynoglossum officinale 	Boraginacées
Cynoglossum amabile 	Cynoglossum amabile 	Borraginacea
Cyprès bleu 	Chamaecyparis 	Cupressacées
Cyprès chauve 	Taxodium distichum 	Taxodiacées
Cyprès de l'Arizona 	Cupressus arizonica 	Cupressacées
Cyprès de Lambert 	Cupressus macrocarpa 	Cupressacées
Cyprès de Lawson 	Chamaecyparis lawsoniana 	Cupressacées
Cyprès de Leyland 	Cupressocyparis X leylanii 	Cupressacées
Cyprès méditerranéen 	Cupressus sempervirens 	Cupressacées
Cyrtomium de Fortune 	Cyrtomium fortunei 	Dryopteridaceae
Cystopteris alpin 	Cystopteris alpina 	Woodsiaceae
Cytinet 	Cytinus hypocistis 	Rafflésiacées
Cytinet rouge 	Cytinus ruber 	Cytinaceae
Cytise 	Laburnum anagyroides 	Fabacées
Cytise velu 	Cytisus villosus 	Fabaceae
Daboécie ou bruyère des Monts Cantabriques 	Daboecia cantabrica 	Ericacées
Dactyle pelotonné 	Dactylis glomerata 	Poacées
Dactylorhiza à large éperon 	Dactylorhiza saccifera 	Orchidacées
Dactylorhize à larges feuilles 	Dactylorhiza majalis 	Orchidaceae
Dactylorhize petit majalis 	Dactylorhiza parvimajalis 	orchidacées
Danthonie inclinée 	Sieglingia decumbens 	Poacées
Daphné camélée 	Daphné cneorum 	Thyméléacée
Daphné des Alpes 	Daphne alpina 	Thyméléacées
Datura stramoine 	Datura stramonium 	Solanacées
Dauphinelle de Requien 	Delphinium pictum subsp. requienii 	Ranunculaceae
Dauphinelle du dauphiné 	Delphinium dubium 	Renonculacées
Dauphinelle fendue 	Delphinium fissum 	Renonculacées
Dédalée du Chêne 	Daedalea quercina 	Fomitopsidacée
Dendrobium bigibbum 	Dendrobium bigibbum 	Orchidacées
Dentaire à cinq folioles 	Cardamine pentaphyllos 	Brassicacées
Dentaire pennée 	Cardamine heptaphylla 	Brassicacées
Dentellaire du cap 	Plumbago capensis 	Plumbaginacée
Dermatocarpon 		
Désespoir du peintre 	Saxifraga umbrosa 	Saxifragacées
Deutzia 	Deutzia scabra 	SAXIFRAGACEES
Dictame blanc 	Dictamnus albus 	Rutacées
Dictame crétois 	Origanum dictamnum 	Lamiacées
Digitaire sanguine 	Digitaria sanguinalis 	Poacées
Digitale à grandes fleurs 	Digitalis grandiflora 	Scrophulariacées
Digitale jaune 	Gigitalis lutea 	Scrophulariacées
Digitale pourpre 	Digitalis purpurea 	Scrophulariacées
Diotis maritime 	Otanthus maritimus 	Astéracées
Dipladenia ou Mandevilla 	Mandevilla sanderi 	Apocynacées
Diploïca 		
Diploschiste 		
Diss, canne de Mauritanie 	Ampelodesmos mauritanicus 	Poaceae
Dompte-venin 	Vincetoxicum hirundinaria 	Asclépiadacées
Dompte-venin de Sibérie 	Vincetoxicum sibericum 	Asclépiadacées
Dorine à feuilles alternes 	Chrysosplenium alternifolium 	Saxifragacées
Dorine à feuilles opposées 	Chrysosplenium oppositifolium 	Saxifragacées
Doronic d'Autriche 	Doronicum austriacum 	Asteraceae
Doronic de Clusius 	Doronicum clusii 	Astéracées
Doronic tue-panthère 	Doronicum pardalianches 	Astéracées
Doronique à grande fleur 	Doronicum grandiflorum lam 	Asteracées
Dorycnie à 5 feuilles 	Dorycnium pentaphyllum 	Fabacées
Douglas 	Pseudotsuga menziesii 	Pinacées
Dracocéphale d'Autriche 	Dracocephalum austriacum 	Lamiaceae
Dracocéphale de Ruysch 	Dracocephalum ruyschiana 	Lamiacées
Drave des murailles 	Draba muralis 	Brassicaceae
Drave faux aîzoon 	Draba aizoides 	Brassicacées
Drave printanière 	Erophila verna 	Brassicacées
Drosera de Madagascar 	Drosera madagascariensis 	Droseracae
Dryopteris à odeur de foin 	Dryopteris aemula 	Dryoptéridacées
Dryoptéris de Chartreuse 	Dryopteris carthusiana 	Dryoptéridacées
Dryoptéris dilaté 	Dryopteris dilatata 	Dryoptéridacées
Dryoptéris écailleux 	Dryopteris affinis 	Dryoptéridacées
Duranta 	Duranta repens "Geisha Girl" 	Verbenacées
Edelweiss 	Leontopodium alpinum 	Astéracées
Egilope ovale 	Aegilops ovata 	Poacées
Elatine à six étamines 	Elatine hexandra 	Elatinacées
Elodée à feuilles étroites 	Elodea nuttallii 	Hydrocharitacées
Elodée crépue 	Lagarosiphon major 	Hydrocharitacées
Elodée dense 	Egeria densa 	Hydrocharitacées
Elodée du Canada 	Elodea canadensis 	Hydrocharitacées
Entolome livide 	Entoloma lividum 	Entolomacées
Epervière à feuilles de chicorée 	Hieracium intybaceum 	Astéracées
Épervière à poils 	Hieracium piliferum 	Asteraceae
Epervière bifide 	Hieracium bifidum 	Astéracées
Epervière de Savoie 	Hieracium sabaudum 	Astéracées
Epervière des dunes 	Hieracium eriophorum 	Astéracées
Epervière des glaciers 	Hieracium glaciale 	Astéracées
Epervière des murs 	Hieracium murorum 	Astéracées
Épervière des prés 	Hieracium pratense 	Astéracées
Epervière en ombelle 	Hieracium umbellatum 	Astéracées
Epervière humble 	Hieracium humile 	Astéracées
Epervière laineuse 	Hieracium lanatum/tomentosum 	Astéracées
Epervière lisse 	Hieracium laevigatum 	Astéracées
Epervière orangée 	Hieracium aurantiacum 	Astéracées
Epervière peinte 	Hieracium pictum 	Astéracées
Epervière petite laitue 	Hieracium latucella 	Astéracées
Epervière piloselle 	Hieracium pilosella 	Astéracées
Epervière velue 	Heriacium villosum 	Astéracées
Epervière vulgaire 	Hieracium vulgatum 	Astéracées
Ephedra 	Ephedra aphylla 	Ephedracées
Ephèdre de Przewalski 	Ephedra przewalskii 	Ephédracées
Ephémère de Virginie 	Tradescantia andersoniana 	Commélinacées
Epiaire à feuilles de sauge 	Stachys germanica subsp. salviifolia 	Lamiaceae
Epiaire de Corse 	Stachys corsica 	Lamiacées
Epiaire des Alpes 	Stachys alpina L., 1753 	Lamiaceae
Epiaire des bois 	Stachys sylvatica 	Lamiacées
Épiaire des champs 	Stachys arvensis 	Lamiaceae
Epiaire des marais 	Stachys palustris 	Lamiacées
Epiaire droite 	Stachys recta 	Lamiacées
Epiaire du Monte Prada 	Stachys pradica 	Lamiacées
Epiaire officinale 	Stachys betonica 	Labiées
Epiaire poisseuse 	Stachys glutinosa 	Lamiacées
Epicéa commun 	Picea abies 	Pinacées
Epicéa de Sitka 	Picea sitchensis 	Pinacées
Epilobe à feuille de mouron 	Epilobium anagallidifolium Lam. 	Onagraceae
Epilobe à feuilles d'alsine 	Epilobium alsinifolium 	Onagracées
Epilobe à feuilles de romarin 	Epilobium dodonaei 	Onagracées
Epilobe à petites fleurs 	Epilobium parviflorum 	Onagracées
Epilobe des montagnes 	Epilobium montanum 	Onagracées
Epilobe des moraines 	Epilobium dodonaei fleischeri 	Onagracées
Epilobe en épi 	Epilobium angustifolium 	Onagracées
Epilobe foncé 	Epilobium obscurum 	Onagracées
Epilobe hérissé 	Epilobium hirsutum 	Onagracées
Epinard-fraise en baguette 	Blitum virgatum 	Chénopodiacées
Epine-vinette 	Berberis vulgaris 	Berbéridacées
Epine-vinette de l'Etna 	Berberis aetnensis 	Berberidacées
Epipactis à feuilles larges 	Epipactis helleborine 	Orchidacées
Epipactis à petites feuilles 	Epipactis microphylla 	Orchidacées
Epipactis de Müller 	Epipactis muelleri 	Orchidacée
Epipactis des marais 	Epipactis palustris 	Orchidacées
Epipactis pourpre 	Epipactis purpurata 	Orchidacées
Epipactis rouge sombre 	Epipactis atrorubens 	Orchidacées
erable 	Acer 	aceracées
Erable à feuilles d'obier 	Acer Opalus 	Acéracées
Erable champêtre 	Acer campestre 	Acéracées
Erable de Montpellier 	Acer monspessulanum 	Acéracées
Erable du Japon 	Acer palmatum 	Acéracées
Erable negundo 	Acer negundo 	Acéracées
Erable plane 	Acer platanoides 	Acéracées
Erable sycomore 	Acer pseudoplatanus 	Acéracées
Erigeron du Canada 	Erigeron canadensis 	Asteraceae
Erine des Alpes 	Erinus alpinus 	Scrophulariacées
Erodium à feuilles de mauve 	Erodium malacoides 	Géraniacées
Erodium à feuilles de mauves 	Erodium malacoides 	Geraniacée
Erodium bec de cigogne 	Erodium ciconium 	Géraniacées
Erodium Bec-de-grue 	Erodium cicutarium 	Géraniacées
Erodium de Corse 	Erodium corsicum 	Geraniacées
Erodium de Lebel ou glutineux 	Erodium lebelii 	Géraniacées
Erodium fétide 	Erodium foetidum 	Géraniacées
Erodium glanduleux 	Erodium glandulosum 	Géraniacées
Erodium guttatum 	Erodium guttatum 	Géraniacées
Erodium musqué 	Erodium moschatum 	Géraniacées
Érodium sans tige 	Erodium acaule 	Geraniacées
Erophaca bétique 	Erophaca baetica 	Fabacées
Erythrone dent de chien 	Erythronium dens-canis 	Liliacées
Escallonia 	Escallonia macrantha 	Grossulariacées
Essai d'abre 	Essaius Arbus 	
Essai3 	Essaius3 	
Etoile d'eau 	Damasonium alisma 	Alismatacées
Étoile d'eau à graines nombreuses 	Damasonium polyspermum 	Alismataceae
Etoile du liotard 	Gagea fistulosa 	Liliacées
Eucalyptus 	Eucalyptus gunni 	MYRTACEES
Eufragie à larges feuilles 	Parentucellia latifolia 	Scrophulariacées
Eupatoire chanvrine 	Eupatorium cannabinum 	Astéracées
Euphorbe à deux ombelles 	Euphorbia biumbellata 	Euphorbiacées
Euphorbe à feuilles de pin 	Euphorbia pinifolia 	Euphorbiacées
Euphorbe à feuilles en coin 	Euphorbia cuneifolia Guss., 1826 	Euphorbiaceae
Euphorbe à tige anguleuse 	Euphorbia angulata 	Euphorbiacées
Euphorbe arborescente 	Euphorbia dendroides 	Euphorbiacées
Euphorbe arborescente. 	Euphorbia dendroides 	Euphorbiacées
Euphorbe Characias 	Euphorbia characias 	Euphorbiacées
Euphorbe d'Irlande 	Euphorbia hyberna 	Euphorbiacées
Euphorbe de Corse 	Euphorbe myrsinites 	Euphorbiaceae
Euphorbe de Loiseleur 	Euphorbia seguieriana subsp. loiseleurii 	Euphorbiacées
Euphorbe de Nice 	Euphorbia nicaeensis 	Euphorbiacées
Euphorbe de Portland 	Euphorbia portlandica 	Euphorbiacées
Euphorbe de Séguier 	Euphorbia seguieriana var. seguieriana 	Euphorbiaceae
Euphorbe de Terracine 	Euphorbia terracina 	Euphorbiaceae
Euphorbe de Turin 	Euphorbia taurinensis 	Euphorbiacée
Euphorbe dentée en scie 	Euphorbia serrata 	Euphorbiacées
Euphorbe des baléares 	Euphorbia pithyusa 	Euphorbiacées
Euphorbe des jardins 	Euphorbia peplus 	Euphorbiacées
Euphorbe des moissons 	Euphorbia segetalis 	Euphorbiacées
Euphorbe des sables 	Euphorbia paralias 	Euphorbiacées
Euphorbe douce 	Euphorbia dulcis 	Euphorbiacées
Euphorbe épineuse 	Euphorbia spinosa 	Euphorbiacées
Euphorbe ésule 	Euphorbia esula 	Euphorbiacées
Euphorbe faux amandier 	Euphorbia amygdaloides 	Euphorbiacées
Euphorbe faux peplus 	Euphorbia peplus subsp. peploides 	Euphorbiaceae
Euphorbe fluette 	Euphorbia exigua 	Euphorbiacées
Euphorbe lathyris 	Euphorbia lathyris 	Euphorbiacées
Euphorbe maculée 	Euphorbia maculata 	Euphorbiacées
Euphorbe petit cyprès 	Euphorbia cyparisias 	Euphorbiacées
Euphorbe polychrome 	Euphorbia epithymoides 	Euphorbiacées
Euphorbe prostrée 	Euphorbia prostrata 	Euphorbiacées
Euphorbe raide 	Euphorbia serrulata 	Euphorbiacées
Euphorbe réveille-matin 	Euphorbia helioscopia 	Euphorbiacées
Euphorbe verruqueuse 	Euphorbia verrucosa 	Euphorbiacées
Euphraise à feuilles en peigne 	Euphrasia pectinata 	Orobanchaceae
Euphraise casse-lunette 	Euphrasia oficinalis 	Scrophulariacées
Euphraise de Salzbourg 	Euphrasia salisburgensis 	Orobanchaceae
Euphraise des Alpes 	Euphrasia Alpina 	Orobanchaceae († Scrophulariaceae)
Euphraise dressée 	Euphrasia stricta 	Orobanchaceae
Euphraise naine 	Euphrasia minima 	Scrophulariacées
Euphraise rouge 	Odontites vernus 	Scrophulariacées
Evax rond ou tyrrhénien 	Filago tyrrhenica 	Asteraceae
Evernia 		
Exochorda 	Exochorda racemosa 	Rosacées
Fabagelle 	Zygophyllum fabago 	Zygophyllacées
Faham 	Jumellea fragrans 	Orchidacea
Fausse pâquerette 	Aster bellidiastrum 	Astéracées
Fausse roquette 	Diplotaxis erucoïdes 	Brassicacées
Fausse roquette à feuilles de cresson 	Erucastrum nasturtiifolium 	Brassicaceae
Faux clitocybe de l'olivier 	Omphalotus olearius 	Omphalotacées
Faux clitocybe lumineux 	Omphalotus illudens 	Omphalotacées
Faux cyprès de Nootka 	Chamaecyparis nootkatensis 	Cupressacées
Faux fraisier 	Potentilla sterilis 	Rosacées
Faux Indigo 	Amorpha fruticosa 	Fabacées
Faux nénuphar 	Nymphoides peltata 	Menyanthacées
Faux-baguenaudier 	Hippocrepis emerus 	Fabacées
Faux-riz 	Leersia oryzoïdes 	Poacées
Feijoa 	Feijoa sellowiana 	Myrtacées
Fenouil commun 	Foeniculum vulgare 	Apiacées
Fer à cheval 	Hippocrepis comosa 	Fabacées
Fer à cheval à plusieurs fruits 	Hippocrepis ciliata 	Fabacées
Férule commune 	Ferula communis 	Apiacées
Fétuque de Leman 	Festuca lemanii 	Poacées
Fétuque élevée 	Festuca arundinacea 	Poacées
Fétuque faux roseau 	Schedonorus arundinaceus 	Poacées
Fétuque gispet 	Festuca eskia 	Poacées
Fétuque rouge 	Festuca rubra 	Poacées
Févier d'Amérique 	Gleditsia triacanthos 	Fabacées
Ficaire fausse renoncule 	Ranunculus ficaria 	Renonculacées
Ficoïde glaciale 	Mesembryanthemum crystallinum 	Aïzoacées
Ficoïde nodiflore 	Mesembryanthemum nodiflorum 	Aïzoacées
Figuier 	Ficus carica 	Moracées
Figuier de barbarie 	Opunta ficus-indica 	Cactacées
Filaire à feuilles étroites 	Phillyrea angustifolia 	Oléacées
Filaire à feuilles larges 	Phillyrea latifolia 	Oleaceae
Filao 	Casuarina 	Casuarinacées
Filipendule 	Filipendula vulgaris 	Rosacées
Flamboyant 	Delonix regia 	Caesalpiniaceae
Fleur de lune, lis de la paix, spathiphylle de Wallis 	Spathiphyllum wallisii 	Araceae
Fleur de tan 	Fuligo septica 	Physaraceae
Flouve aristée 	Anthoxanthum aristatum 	Poacées
Flouve odorante 	Anthoxanthum odoratum 	Poacées
Flûteau fausse-renoncule 	Baldellia ranunculoïdes 	Alismatacées
Flûteau nageant 	Luronium natans 	Alismatacées
Folle avoine 	Avena fatua 	Poacées
Forsythia 	Il n'y en a point 	Oléacées
Fougère aigle 	Pteridium aquilinum 	Hypolépidacées
Fougère de Crète 	Pteris cretica 	Pteridaceae
Fougère des montagnes 	Oreopteris limbosperma 	Thélyptéridacées
Fougère femelle 	Athyrium filix-femina 	Athyriacées
Fougère mâle 	Dryopteris filix-mas 	Aspidiacées
Fougère-houx 	Cyrtomium falcatum 	Dryopteridacées
Fourrea des Alpes 	Fourraea alpina 	Brassicacées
Fragon 	Ruscus Hypoglossum 	Asparagacées
Fragon petit houx 	Ruscus aculeatus 	Liliacées
Fraisier à fleur jaune 	Potentilla indica 	Rosaceae
Fraisier des Indes 	Duchesnea indica 	Rosacées
Fraisier sauvage 	Fragaria vesca 	Rosacées
Fraisier vert 	Fragaria viridis 	Rosacées
Fraisiers 	Fragaria 	Rosacées
Framboisier 	Rubus idaeus 	Rosacées
Frankénie hirsute 	Frankenia hirsuta 	Frankéniacées
Frêne à fleurs 	Fraxinus ornus 	Oléacées
Frêne commun 	Fraxinus excelsior 	Oléacées
Frêne oxyphylle 	Fraxinus angustifolia 	Oléacées
Fritillaire à involucre 	Fritillaria involucrata 	Liliacées
Fritillaire d'Orient ou de Caussols 	Fritillaria montana 	Liliacées
Fritillaire de Burnat 	Fritillaria burnatii 	Liliaceae
Fritillaire des Pyrénées 	Fritillaria nigra 	Liliacée
Fritillaire du Dauphiné 	Fritilllaria tubiformis subsp. tubiformis 	Liliaceae
Fritillaire impériale ou Larmes de Marie 	Fritillaria imperialis 	Liliaceae
Fritillaire Pintade 	Fritillaria meleagris 	Liliacées
Fuchsia magellanica 	Phygelius 	Fuchsia
Fuligo septica 	Fuligo septica 	Myxomycètes
Fumana des montagnes 	Fumana ericoides ssp montana 	Cistacées
Fumeterre des murs 	Fumaria muralis 	Fumariacées
Fumeterre grimpante 	Fumaria capreolata 	Fumariacées
Fumeterre officinale 	Fumaria officinalis 	Fumariacées
Fumeterre petites fleurs 	Fumaria Parviflora 	Fumariacée
Fusain 	Evonymus 	Célastrinées
Fusain à larges feuilles 	Euonymus latifolius 	Célastracées
Fusain d'Europe 	Euonymus europaeus 	Célastracées
Fuschia 	Fuschia 	Onagracées
Gagée de Bohème (des rochers) 	Gagea bohemica 	Liliaceae
Gagée de liotard 	Gagea fragifera 	Liliacées
Gagée de Reverchon 	Gagea reverchonii 	Liliaceae
Gagée des prés 	Gagea pratensis 	Liliaceae
Gagée feuillue 	Gagea foliosa 	Liliacées
Gagée jaune 	Gagea lutea 	Liliacées
Gailet à grosses graines 	Galium megalospermum 	Rubiacées
Gaillet à feuilles d'asperge 	Galium corrudifolium 	Rubiaceae
Gaillet à feuilles rondes 	Galium rotundifolium 	Rubiacées
Gaillet à trois cornes 	Galium tricornutum 	Rubiaceae
Gaillet boréal 	Galium boreale 	Rubiacées
Gaillet cespiteux 	Gallium cespitosum 	Rubiacée
Gaillet chétif 	Galium debile 	Rubiacées
Gaillet croisette 	Cruciata laevipes 	Rubiacées
Gaillet des bois 	Galium sylvaticum 	Rubiacées
Gaillet des fanges 	Galium uliginosum 	Rubiacées
Gaillet des marais 	Galium palustre 	Rubiacées
Gaillet des Pyrénées 	Gallium pyrenaicum 	Rubiacée
Gaillet des sables 	Galium arenarium 	Rubiacées
Gaillet du Harz 	Galium saxatile 	Rubiacées
Gaillet fluet 	Gaiium pusillum 	Rubiacées
Gaillet glauque 	Galium glaucum 	Rubiacées
Gaillet gratteron 	Galium aparine 	Rubiacées
Gaillet minuscule 	Galium minutulum 	Rubiaceae
Gaillet mollugine 	Galium mollugo 	Rubiacées
Gaillet vrai 	Galium verum 	Rubiacées
Galane 	Chelone obliqua 	Scrophulariacées
Galé odorant 	Myrica gale 	Myricacées
Galéga officinal 	Galega officinalis 	Fabacées
Galéopsis à feuilles étroites 	Galeopsis angustifolia 	Lamiacées
Galéopsis des moissons 	Galeopsis segetum 	Lamiacées
Galéopsis intermédiaire 	Galeopsis ladanum subsp. ladanum 	Lamiaceae
Galéopsis splendide 	Galeopsis speciosa 	Lamiacées
Galéopsis tétrahit 	Galeopsis tetrahit 	Lamiacées
Galère marginée 	Galerina marginata 	Crepidotacées
Galinsoga à petites fleurs 	Galinsoga parviflora 	Asteraceae
Galinsoga cilié 	Galinsoga ciliata 	Astéracée
Ganoderme luisant 	Ganoderma lucidum 	Polyporacées
Garance des teinturiers 	rubia tinctorium 	Rubiaceae
Garance voyageuse 	Rubia peregrina 	Rubiacées
Garidelle fausse nigelle 	Garidella nigellastrum 	Ranunculaceae
Gattilier 	Vitex agnus castus 	Lamiacées ex verbénacées
Gaudinie fragile 	Gaudinia fragilis 	Poacées
Gazanie 	Gazania 	Astéracées
Gazon d'Olympe 	Armeria maritima 	Plombaginacées
Génépi jaune 	Artemisia glacialis 	Astéracées
Génépi noir 	Artemisia genipi 	Asteracées
Genet 	Cytisus x praecox 	Fabacées
Genêt à balais 	Cytisus scoparius 	Fabacées
Genêt bâtard 	Adenocarpus complicatus 	Papilionacées
Genêt d'Allemagne 	Genista germanica 	Fabacées
Genêt d'Angleterre 	Genista anglica 	Papilionacées
Genêt d'Espagne 	Genista hispanica 	Fabacées
Genêt de Lobel 	Genista lobelii 	Fabacées
Genêt de Villars 	Genista pulchella ssp villarsii 	Fabacées
Genêt des teinturiers 	Genista tinctoria 	Fabacées
Genêt épineux 	Genista scorpius 	Fabaceae
Genêt hirsute 	Genista hirsuta 	Fabacées
Genêt poilu 	Genista pilosa 	Fabacées
Genêt purgatif 	Cytisus oromediterraneus 	Fabacées
Genêt sagitté 	Chamaespartium sagittale 	Fabacées
Genévrier commun 	Juniperus communis 	Cupressacées
Genévrier de Phénicie 	Juniperus phoenicea 	Cupressacées
Genévrier nain 	Juniperus sibirica 	Cupressacées
Genevrier oxycèdre 	Juniperus oxycedrus 	Cupressacées
Gennarie à deux feuilles 	Gennaria diphylla 	Orchidaceae
Gentiane à feuilles courtes 	Gentiana brachyphylla 	Gentianacées
Gentiane à feuilles étroites 	Gentiana angustifolia 	Gentianacées
Gentiane acaule 	Gentiana acaulis 	Gentianacées
Gentiane algide 	Gentiana algida 	Gentianacées
Gentiane aquatique 	Gentiana aquatica 	Gentianacées
Gentiane asclépiade 	Gentiana asclepiadea 	Gentianacées
Gentiane champêtre 	Gentianella campestris 	Gentianacées
Gentiane ciliée 	Gentianella ciliata 	Gentianacées
Gentiane croisette 	Gentiana cruciata 	Gentianacées
Gentiane d'Allemagne 	Gentianella germanica 	Gentianacées
Gentiane de Bavière 	Gentiana bavarica 	Gentianacées
Gentiane de Burser 	Gentiana burseri 	Gentianacées
Gentiane de Clusius 	Gentiana clusii 	Gentianacées
Gentiane de Ligurie 	Gentiana ligustica 	Gentianaceae
Gentiane délicate 	Gentianella tenella 	Gentianacées
Gentiane des neiges 	Gentiana nivalis 	Gentianacées
Gentiane des Pyrénées 	Gentiana pyrenaica 	Gentianacées
Gentiane jaune 	Gentiana lutea 	Gentianacées
Gentiane occidentale 	Gentiana occidentalis 	Gentianacées
Gentiane pneumonanthe 	Gentiana pneumonanthe 	Gentianacées
Gentiane ponctuée 	Gentiana punctata 	Gentianacées
Gentiane pourpre 	Gentiana purpurea 	Gentianacées
Gentiane printanière 	Gentiana verna 	Gentianacées
Géranium 	Géranium x 	Géraniacées
Géranium à feuilles de mauve 	Geranium malviflorum 	Geraniaceae
Geranium à feuilles découpées 	Geranium dissectum 	Géraniacées
Geranium à feuilles rondes 	Geranium rotundifolium 	Géraniacées
Geranium à tige noueuse 	Geranium nodosum 	Geraniacées
Géranium cendré 	Geranium cinereum 	Géraniacées
Géranium colombin 	Geranium columbinum 	Géraniacées
Géranium des bois 	Geranium sylvaticum 	Géraniacées
Géranium des marais 	Geranium palustre 	Géraniacées
Géranium des prés 	Géranium pratense 	Géraniacée
Géranium des Pyrénées 	Géranium pyrenaicum 	Géraniacées
Géranium fluet 	Geranium pusillum 	Géraniacées
Géranium herbe à Robert 	Geranium robertianum 	Géraniacées
Géranium laineux 	Geranium lanuginosum 	Géraniacées
Géranium livide 	Geranium phaeum 	Géraniacées
Géranium luisant 	Geranium lucidum 	Géraniacées
Geranium mou 	Geranium molle 	Géraniacées
Géranium pourpré 	Geranium robertianum subsp. purpureum 	Géraniacées
Géranium sanguin 	Geranium sanguineum 	Géraniacées
Germandée arbustive 	Teucrium fructicans 	Lamiacées-labiées
Germandrée blanc-grisâtre 	Teucrium Polium 	Lamiaceae
Germandrée des chats 	Teurcrium marum 	Lamiacées
Germandrée des montagnes 	Teucrium montanum 	Lamiacées
Germandrée des Pyrénées 	Teucrium pyrenaicum 	Lamiacées
Germandrée dorée 	Teucrium aureum 	Lamiacées
Germandrée en grappe 	Teucrium botrys 	Lamiaceae
Germandrée faux petit-pin 	Teucrium pseudochamaepytis 	Lamiacées
Germandrée petit-chêne 	Teucrium chamaedrys 	Lamiacées
Germandrée scorodoine 	Teucrium scorodonia 	Labiées
Gesce filiforme 	Lathyrus filiformis 	Fabaceae
Gesse à feuilles de deux formes 	Lathyrus heterophyllus 	Fabaceae
Gesse à feuilles fines 	Lathyrus setifolius 	Fabaceae
Gesse à larges feuilles 	Lathyrus latifolius 	Fabacées
Gesse à vrille 	Lathyrus cirrhosus 	Fabaceae
Gesse annuelle 	Lathyrus annus 	Fabacées
Gesse aphaca 	Lathyrus aphaca 	Fabacées
Gesse clymène 	Lathyrus clymenum 	Fabacée (Fabaceae)
Gesse de Nissole 	Lathyrus nissolia 	Fabacées
Gesse des montagnes 	Lathyrus montanus 	Fabacées
Gesse des prés 	Lathyrus pratensis 	Fabacées
Gesse jaune 	Lathyrus laevigatus 	Fabacées
Gesse noire 	Lathyrus niger 	Fabacées
Gesse printanière 	Lathyrus vernus 	Fabacées
Gesse sauvage 	Lathyrus sylvestris 	Fabacées
Gessette 	Lathyrus cicera 	Fabacée
Gigembre rouge 	Alpinia Purpurata 	Zingibéracées
Gingembre 	Zingiber officinale 	Zingibéracées
Giroflée 	Erysimum 	Cruciféracées
Giroflée arbustif 	Erysimum linifolium "bowles mauve" 	Cruciferacée
Giroflée des dunes 	Matthiola sinuata 	Brassicacées
Giroflée des jardins 	Matthiola incana 	Brassicacées
Giroflée des murailles 	Erysimum cheiri (L.) Crantz 	Brassicaceae
Girolle 	Cantharellus cibarius 	Cantharellacées
Glaïeul commun 	Gladiolus communis 	Iridacées
Glaïeul d'Illyrie 	Gladiolus illyricus 	Iridacées
Glaïeul d'Italie 	Gladiolus italicus 	Iridacées
Globulaire à feuilles en coeur 	Globularia cordifolia 	Globulariacées
Globulaire à tige nue 	Globularia nudicaulis 	Globulariacées
Globulaire allongée 	Globularia bisvagarica 	Globulariacée
Globulaire buissonnante 	Globularia alypum 	Globulariaceae
Globulaire commune 	Globularia punctata 	Globulariacées
Globulaire rampante 	Globularia repens 	Globulariacée
Gnaphale couché 	Gnaphalium supinum 	Astéracées
Gnaphale de Hoppe 	Gnaphalium hoppeanum 	Astéracées
Gnaphale de Norvège 	Gnaphalium norvegicum 	Astéracées
Gnaphale des bois 	Omalotheca sylvatica 	Astéracées
Gnaphale des marais 	Gnaphalium uliginosum 	Astéracées
Gnaphale jaunâtre 	Gnaphalium luteo-album 	Astéracées
Gnavelle annuelle 	Scleranthus annuus 	Caryophyllacées
Gnavelle vivace 	Scleranthus perennis 	Caryophyllacées
Gommier, Omina (Drehu) 	Cordia Dichotoma 	Boraginacées
Goodyère rampante 	Goodyera repens 	Orchidacées
Gouffée des sables 	Arenaria provincialis 	Caryophyllaceae
Grand boucage 	Pimpinella major 	Apiacées
Grand Liseron 	Convolvulus sepium 	Convolvulaceae
Grand muflier Gueule de Lion 	Antirrhinum majus 	Plantaginaceae
Grand orpin 	Hylotelephium maximum 	Crassulacées
Grand plantain 	Plantago major 	Plantaginacées
Grand Statice 	Limoniastrum monopetalum 	Plombaginacées
Grande Astrance 	Astrantia major 	Apiacées
Grande Aunée 	Inula helenium 	Astéracées
Grande Bardane 	Arctium lappa 	Astéracées
Grande Brize 	Briza maxima 	Poacées
Grande camomille 	Tanacetum parthenium 	Astéracées
Grande ciguë 	Conium maculatum 	Apiacées
Grande douve 	Ranunculus lingua 	Renonculacées
Grande Glycérie 	Glyceria maxima 	Poacées
Grande lentille d'eau 	Spirodela polyrrhiza 	Lemnacées
Grande Pervenche 	Vinca major 	Apocynacées
Grande pimprenelle 	Sanguisorba officinalis 	Rosacées
Grande Porcelle 	Hypochaeris uniflora 	Asteraceae
Grande-Marguerite 	Leucanthemum vulgare Lam. 	Astéraceae
Grassette à éperon grêle 	Pinguicula leptoceras 	Lentibulariaceae
Grassette à grandes fleurs 	Pinguicula grandiflora 	Lentibulariacées
Grassette corse 	Pinguicula corsica 	Lentibulariées
Grassette de Reichenbach 	PInguicula reichenbachiana 	Lentibulariacées
Grassette des Alpes 	Pinguicula alpina 	Lentibulariacées
Grassette du Portugal 	Pinguicula lusitanica 	Utriculariacées
Grassette vulgaire 	Pinguicula vulgaris 	Lentibulariacées
Gratiole officinale 	Gratiola officinalis 	Scrophulariacées
Gregoria fausse joubarbe 	Androsace vitaliana 	Primulacées
Grémil couché 	Lithodora prostrata 	Boraginacées
Grémil de Gaston 	Lithospermum gastonii Benth 	Borraginacées
Grémil des champs 	Buglossoides arvensis ex lithospermum arvense 	Boraginacées
Grémil diffus 	Lithodora diffusa 	Boraginacées
Grémil du Portugal 	Lithodora prostrata subsp. lusitanicum 	Boraginacées
Grémil jaune 	Neatostema apulum 	Boraginacées
Grémil ligneux 	Lithodora fructicosa 	Boraginacea
Grémil officinal 	Lithospermum officinale 	Boraginacées
Grémil pourpre bleu 	Buglossoides purpurocaerulea 	Boraginacées
Grenadier 	Punica granatum 	Punicacées
Grenadier nain 	Punica granatum "chico" 	Punicaceae
Griffe de sorcière 	Carpobrotus acinaciformis 	Aizoacées
Griselinie du littoral 	Griselinia littoralis 	Cornacées
Groseillier à maquereau 	Ribes uva-crispa 	Grossulariacées
Groseillier des Alpes 	Ribes alpinum 	Grossulariacées
Groseillier rouge 	Ribes rubrum 	Grossulariacées
Gueule de loup 	Antirrhinum latifolium 	Scrophulariacées
Gui 	Viscum Album 	Loranthacées
Gui du genévrier 	Arceuthobium oxycedri 	Viscaceae
Guimauve 	Althaea officinalis 	Malvacées
Guimauve Faux-Chanvre 	Althaea cannabina 	Malvacées
Guimauve officinale 	Althaea officinalis L., 1753 	Malvaceae
Gunnera 	Gunnera 	Halorragidacées
Gypsophile des murailles 	Gypsophila muralis 	Caryophyllacées
Gypsophile rampante 	Gypsophila repens 	Caryophyllacées
Gyromitre 	Gyromitra esculenta 	Helvellacées
Hébélome à odeur de moutarde 	Hebeloma sinapizans 	Bolbitiacées
Hélénie 	Hélénium 	Astéracées
Helianthe 	Helianthus atrorubens 	Astéracées
Hélianthème à calice persistant 	Halimium calycinum 	Cistacées
Hélianthème à feuille d'arroche 	Halimium halimifolium 	Cistacées
Hélianthème à feuilles de lavande 	Helianthemum lanvandulifolium 	Cistacées
Hélianthème à feuilles de nummulaire 	Helianthemum nummularium 	Cistacées
Hélianthème à gouttes 	Tuberaria guttata 	Cistaceae
Hélianthème à grandes fleurs 	Helianthemum grandiflorum 	Cistacées
Helianthème à lunules 	Helianthemum lunulatum 	Cistacées
Hélianthème blanchâtre 	Helianthemun oleandicum ssp incanum 	Cistacées
Hélianthème de Syrie 	Helianthemum syriacum 	Cistacées
Hélianthème des apennins 	Helianthemum apenninum 	Cistacée
Hélianthème en ombelles 	Halimium umbellatum 	Cistacées
Hélianthème hérissé 	Helianthemum hirtum 	Cistacées
Hélianthème poilu 	Helianthemum violaceum (Cav.) Pers. Cistaceae 	Cistaceae
Hélianthème semi-glabre 	Helianthemum nummularium subsp. semi-glabrum 	Cistaceae
Hélianthème tubéraire 	Diatelia tuberaria 	Cistacées
Hélicrysum d'Italie 	Helicrysum italica 	Astéracées
Héliotrope d'Europe 	Heliotropium europaeum 	Boraginacées
Heliotrope hirsute 	Heliotropium hirsutissimum 	Boraginacées
Hellébore d'hiver 	Eranthis hyemalis 	Renonculacées
Hellébore de Corse 	Helleborus argutifolius 	Renonculacées
Hellébore fétide 	Helleborus foetidus 	Renonculacées
Hellébore niger 	Helleborus niger 	Renonculacées
Hellébore noir 	Helleborus niger 	Ranunculaceae
Hellébore vert 	Helleborus viridis 	Renonculacées
Hellébores - Espèces cultivées 	Helleborus 	Renonculaceae
Helvelle crépue 	Helvella crispa 	Helvellacées
Hémérocalle 	Hemerocallis 	Liliacée
Hepatique noble 	hepatica nobilis 	renonculacées
Herbe à chat 	Cyperus zumula 	Cypéracée
Herbe au cerfs 	Cervaria rivini 	Apiacées
Herbe de la pampa 	Cortaderia selloana 	Poacées
Herniaire maritime 	Herniaria ciliolata 	Caryophyllacées
Hêtre 	Fagus sylvatica 	Fagacées
Hibiscus 	Hibiscus 	Malvacées
Holostée hirsute 	Holosteum umbellatum subsp. hirsutum 	Caryophyllacées
Homogyne des Alpes 	Homogyne alpina 	Astéracées
Horminelle des Pyrénées 	Horminum pyrenaicum 	Lamiacées
Hornungie des rochers (hutchinsie) 	Hornungia petraea 	Brassicaceae
Hottonie des marais 	Hottonia palustris 	Primulacées
Houblon 	Humulus lupulus 	Cannabacées
Houlque laineuse 	Holcus lanatus 	Poacées
Houlque molle 	Holcus mollis 	Poacées
Houstonie bleue 	Houstonia caerulea 	Rubiacé
Houx 	Ilex aquifolium 	Aquifoliacées
Hutchinsie des Alpes 	Pritzelago alpina 	Brassicacée
Hydne de peck 	Hydnellum peckii 	Hydnacées
Hydne en corail 	Hericium clathroïdes 	Hydnacées
Hydrocotyle 	Hydrocotyle vulgaris 	Apiacées
Hydrophylle de virginie 	Hydrophyllum virginianum 	Hydrophyllacées
Hygrophore à pied jaune 	Cuphophyllus flavipes 	Hygrophoracées
Hygrophore comestible 	Hygrophorus penarius 	Hygrophoracées
Hygrophore de mars 	Hygrophorus marzuolus 	Hygrophoracées
Hygrophore des prés 	Cuphophyllus pratensis 	Hygrophoracées
Hygrophore ivoirin 	Hygrophorus eburneus 	Hygrophoracées
Hygrophore persistant 	Hygrocybe persistens 	Hygrophoraceae
Hyoséris rayonnante 	Hyoseris radiata 	Astéracées
Hypholome en touffes 	Hypholoma fasciculare 	Strophariacées
Hysope officinale 	Hyssopus officinalis 	Lamiacées
Ibéris à feuilles de lin 	Iberis linifolia 	Brassicacées
Ibéris amer 	Iberis amara 	Brassicacées
Iberis des rochers 	Iberis saxatilis 	Brassicaceae
Ibéris du mont aurouze 	Iberis aurosica 	Brassicacées
Ibéris en ombelle 	Iberis umbellata 	Brassicacées
Iberis nain 	Iberis nana 	Brassicacées
Iberis penné 	Iberis pinnata 	Brassicaceae
Ibéris sempervirent 	Iberis Sempervirens 	Brassicaceae
If commun 	Taxus baccata 	Taxacées
Illécèbre verticillé 	Illecebrum verticillatum 	Caryophyllacées
Immortelle d'Italie 	Helychrysum italicum 	Astéracées
Immortelle des frimas 	Castroviejoa frigida 	Astéracées
Immortelle stoechas 	Helichrysum stoechas 	Astéracées
Impatience de Balfour 	Impatiens balfourii 	Balsaminacées
Impatiente glanduleuse 	Impatiens glandulifera 	Balsaminacées
Impératoire 	Peucedanum ostruthium 	Apiacées
Inconu 	Inconu 	Inconnu
Inocybe doux amer 	Inocybe dulcamara 	Cortinariacées
Inocybe du Jura 	Inocybe jurana 	Cortinariacées
Inocybe macule 	Inocybe maculata 	Cortinariacées
Inule à deux faces 	Inula bifrons 	Asteraceae
Inule à feuilles de saule 	Inula salicina 	Asteraceae
Inule à feuilles de spirée 	Inula spiraeifolia 	Asteraceae
Inule conyze 	Inula conyza 	Astéracées
Inule des montagnes 	Inula montana 	Asteraceae
Inule fétide 	Dittrichia graveolens 	Asteracées
Inule perce-pierre 	Inula crithmoides 	Astéracées
Inule visqueuse 	Inula viscosa 	Asteracees
Ipomée japonaise 	Ipomoea nil 	Ipomoea
Iris à feuilles de graminée 	Iris graminea 	Iridaceae
Iris bleu d'Allemagne 	Iris germanica 	Iridaceae
Iris de Reichenbach 	Iris reichenbachiana 	Iridaceae
Iris de Sibérie 	Iris sibirica 	Iridacées
Iris des marais 	Iris pseudacorus 	Iridacées
Iris foetide 	Iris foetida 	Iridacée
Iris lactea 	Iris lactea 	Iridacées
Iris laevigata 	Iris laevigata 	Iridacées
Iris nain 	Iris lutescens 	Iridacées
Iris versicolore 	Iris versicolor 	Iridaceae
Isoète de Durieu 	Isoetes duriaei 	Isoetaceae
Isoète épineux 	Isoetes hystrix 	Isoétacées
Isoète voilé 	Isoetes velata 	Isoetaceae
Isopyre faux-pigamon 	Thalictrella thalictroides 	Renonculacées
Ivraie multiflore 	Lolium multiflorum 	Poacées
Jacinthe d'Orient 	Hyacinthus orientalis 	Asparagaceae
Jacinthe de Pouzols 	Brimeura fastigiata 	Hyacynthaceae
Jacinthe des bois 	Hyacinthoides non-scripta 	Liliacées
Jacinthe romaine 	Bellevalia romana 	Hyacinthacées
Jacobine 	Jacobinia suberecta 	Acanthacées
Jaquier 	Artocarpus heterophyllus 	Moracées
Jasione des montagnes 	Jasione montana 	Campanulacées
Jasmin 	Jasminum polyanthum 	Oleaceae
Jasmin jaune 	Jasminum fruticans 	Oleaceae
Je le recherche,vu en corse dans les calanques de piana 	Inconnu 	
Jonc aggloméré 	Juncus conglomeratus 	Joncacées
Jonc articulé 	Juncus articulatus 	Joncacées
Jonc bulbeux 	Juncus bulbosus 	Joncacées
Jonc capité 	Juncus capitatus 	Joncacées
Jonc de Jacquin 	Juncus jacquinii 	Juncacées
Jonc des Alpes 	Juncus alpinoarticulatus 	Joncacées
Jonc des bois 	Juncus acutiflorus 	Joncacées
Jonc des crapauds 	Juncus bufonius 	Joncacées
Jonc des Pyrénées 	Juncus balticus subso. pyrenaeus 	Juncacées
Jonc épars 	Juncus effusus 	Joncacées
Jonc feuillu 	Juncus foliosus 	Joncacées
Jonc filiforme 	Juncus filiformis 	Juncacées
Jonc fleuri 	Butomus umbellatus 	Butomacées
Jonc grêle 	Juncus tenuis 	Joncacées
Jonc hétérophylle 	Juncus heterophyllus 	Joncacées
Jonc maritime 	Juncus maritimus 	Joncacées
Jonc nain 	Juncus pygmaeus 	Juncacées
Jonc piquant 	Juncus acutus 	Joncacées
Jonquille 	Narcissus pseudo-narcissus 	Amaryllidacées
Joubarbe d'Auvergne 	Sempervivum tectorum subsp. arvernense 	Crassulaceae
Joubarbe des montagnes 	Sempervivum montanum 	Crassulacées
Joubarbe des toits 	Sempervivum tectorum 	Crassulacées
Joubarbe du calcaire 	Sempervivum calcareum Jord., 1849 	Crassulacées
Joubarbe prolifère 	Jovibarba sobolifera 	Crassulacées
Joubarbe toile d'araignée 	Sempervivum arachnoideum 	Crassulacées
Joubarbe tomenteuse 	Sempervivum arachnoideum var. tomentosum 	Crassulaceae
Jujubier 	Ziziphus jujuba 	Rhamnacées
Julienne à feuilles laciniées 	Hesperis laciniata 	Brassicacées
Julienne des Dames 	Hesperis matronalis 	Brassicacées
Jusquiame blanche 	Hyocyamus albus 	Solanacées
Jusquiame dorée 	Hyoscyamus aureus 	Solanacées
Jusquiame noire 	Hyoscyamus niger 	Solanacées
Jussie à grandes fleurs 	Ludwigia grandiflora 	Onagracées
Jussie des marais 	Ludwigia palustris 	Onagracées
Jussie faux-pourpier 	Ludwigia peploïdes 	Onagracées
Kalanchoe daigremontianum 	Bryophyllum daigremontianum 	Crassulaceae
Kalenchoe pinnata 	Bryophyllum pinnata 	Crassulaceae
Kalmia à feuille étroite 	Kalmia angustifolia 	Ericacées
Kernère des rochers 	Kernera saxatilis 	Brassicacées
Kiwi 	Actinidia 	Actinidiacées
Knautie à feuilles entières 	Knautia integrifolia 	Dipsacacées
Knautie de Timeroy 	Knautia Timeroyii 	Caprifoliaceae
Knautie des bois 	Knautia dipsacifolia 	Dipsacacées
Knautie des champs 	Knautia arventis 	Dipsacacées
Knautie des collines 	Knautia collina 	Caprifoliaceae (†Dipsacaceae)
Koelérie blanchâtre 	Koeleria albescens 	Poacées
Kumquat 	Fortunella 	Rutacées
L'Arbre des pagodes 	Styphnolobium japonicum ou Sophors japonica 	Fabacées
Laccaire améthyste 	Laccaria amethystina 	Tricholomatacées
Laccaire laqué 	Laccaria laccata 	Tricholomatacées
Lacrymaire velouté 	Psathyrella lacrymabunda 	Coprinacées
Lactaire à coliques 	Lactarius torminosus 	Russulacées
Lactaire à lait abondant 	Lactarius volemus 	Russulacées
Lactaire à lait jaune 	Lactarius chrysorrheus 	Russulacées
Lactaire camphré 	Lactarius camphoratus 	Russulacées
Lactaire couleur de foie 	Lactarius hepaticus 	Russulacées
Lactaire délicieux 	Lactarius deliciosus 	Russulacées
Lactaire non zoné 	Lactarius azonites 	Russulacées
Lactaire plombé 	Lactarius necator 	Russulacées
Lactaire poivré 	Lactarius piperatus 	Russulacées
Lactaire roux 	Lactarius rufus 	Russulacées
Lactaire velouté 	Lactarius vellereus 	Russulacées
Laîche à 2 nervures 	Carex binervis 	Cyperaceae
Laîche à bec 	Carex rostrata 	Cypéracées
Laîche à deux étamines 	Carex diandra 	Cyperaceae
Laîche à épis séparés 	Carex divulsa 	Cypéracées
Laîche à feuilles filiformes 	Carex chaetophylla 	Cyperaceae
Laîche à fleurs à la base 	Carex depressa subsp. capillaris 	Cyperaceae
Laîche à petites arêtes 	Carex microglochin 	Cyperaceae
Laîche aiguë 	Carex acuta 	Cyperacées
Laîche bicolore 	Carex bicolor 	Cyperaceae
Laîche blanche 	Carex alba 	Cyperaceae
Laîche bleuâtre 	Carex panicea 	Cypéracées
Laîche capilaire 	Carex capillaris 	Cyperaceae
Laîche courbée 	Carex curvula 	Cyperaceae
Laîche cuivrée 	Carex otrubae 	Cypéracées
Laîche de Griolet 	Carex grioletii 	Cyperaceae
Laîche de Haller 	Carex halleriana 	Cyperaceae
Laîche de Host 	Carex hostiana 	Cyperaceae
Laîche de Lachenal 	Carex lachenalii 	Cyperaceae
Laîche des bois 	Carex sylvatica 	Cypéracées
Laîche des îles d'Hyères 	Carex olbiensis 	Cyperaceae
Laîche des lièvres 	Carex ovalis 	Cypéracées
Laîche des renards 	Carex vulpina 	Cyperaceae
Laîche des rives 	Carex riparia 	Cypéracées
Laîche des sables 	Carex arenaria 	Cypéracées
Laîche distante 	Carex distante 	Cyperaceae
Laîche écailleuse 	Carex demissa 	Cypéracées
Laîche élevée 	Carex elata 	Cypéracées
Laïche espacée 	Carex remota 	Cypéracées
Laîche étoilée 	Carex echinata 	Cypéracée
Laîche faux-Souchet 	Carex pseudocyperus 	Cypéracées
Laîche ferrugineuse 	Carex ferruginea subsp. tenax 	Cyperaceae
Laîche glauque 	Carex flacca 	Cypéracées
Laîche hispide 	Carex hispida 	Cyperaceae
Laîche jaune 	Carex flava 	Cyperaceae
Laîche lisse 	Carex laevigata 	Cypéracées
Laîche mucronée 	Carex mucronata 	Cyperaceae
Laîche naine 	Carex humilis 	Cyperacées
Laîche noirâtre 	Carex atrata 	Cyperaceae
Laîche noire 	Carex nigra 	Cypéracées
Laîche pâle 	Carex pallescens 	Cyperaceae
Laîche paniculée 	Carex paniculata 	Cypéracées
Laîche pauvre en fruits 	Carex depauperata 	Cyperaceae
Laîche pendante 	Carex pendula 	Cypéracées
Laîche puce 	Carex pulicaris 	Cypéracées
Laîche vésiculeuse 	Carex vesicaria 	Cypéracées
Laiteron commun 	Sonchus oleraceus 	Astéracées
Laiteron délicat 	Sonchus tenerrimus 	Astéracées
Laiteron des Alpes 	Lactuca alpina 	Asteraceae
Laiteron des champs 	Sonchus arvensis 	Astéracées
Laiteron rude 	Sonchus asper 	Asteracées
Laitue de Plumier 	Cicerbita plumieri 	Astéracées
Laitue des murailles 	Mycelis muralis 	Astéracées
Laitue des vignes 	Lactuca viminea 	Astéracées
Laitue pérenne 	changement 	Astéracées
Laitue sauvage 	Lactuca virosa 	Astéracées
Laitue scariole 	Lactuca serriola 	Astéracées
Laitue très ramifiée 	Lactuca ramosissima 	Astéraceae
Laitue vivace 	Lactuca perennis 	Astéracées
Lamarckie dorée 	Lamarckia aurea 	Poacées
Lamier amplexicaule 	Lamium amplexicaule 	Lamiacées
Lamier bifide 	Lamium bifidum 	Lamiaceae
Lamier blanc 	Lamium album 	Lamiacées
Lamier découpé 	Lamium hybridum 	Labiées
Lamier du mont Gargano 	Lamium garganicum 	Lamiaceae
Lamier hybride 	Lamium hybridum 	Lamiacées
Lamier jaune 	Lamium galeobdolon 	Lamiacées
Lamier maculé 	Lamium maculatum 	Lamiacées
Lamier pourpre 	Lamium purpureum 	Lamiacées
Lampourde anti-scrofuleuse 	Xanthium strumarium 	Astéracées
Lampourde d'Italie 	Xanthium italicum 	Astéracées
Lampsane commune 	Lapsana communis 	Astéracées
Langue-de-boeuf 	Fistulina hepatica 	Fistulinacées
Lanterne japon 	Hibiscus schizopelatus 	Malvacées
Laser à larges feuilles 	Laserpitium latifolium 	Apiacées
Laser de France 	Laserpitium gallicum 	Apiacées
Lathrée clandestine 	Lathraea clandestina 	Orobanchacées
Lathrée écailleuse 	Lathrea squamaria 	Scrophulariacées
Laurentie de Micheli 	Solenopsis laurentia 	Illecebracées
Laurier cerise 	Prunus laurocerasus 	Rosaceae
Laurier des bois 	Daphne laureola 	Thyméléacées
Laurier rose 	Nerium oleander 	Apocynacées
Laurier sauce 	Laurus nobilis 	Lauracées
Laurier tin 	Viburnum tinus 	Adoxaceae
Lavande commune 	Lavandula angustifolia 	Lamiacées
Lavande dentée 	Lavandula dentata 	Lamiacées
Lavande papillon 	Lavandula stoechas 	Lamiaceae
Lavatère arborescente 	Lavatera arborea 	Malvacées
Lavatère maritime 	Lavatera maritima 	Malvaceae
Le calliandre 	Calliandria calothyrsus 	Mimosaceae
Le topinambour 	Helianthus tuberosus 	Astéracées
Lecanora 		
Lédebouria 	Ledebouria 	Hyacinthacées
Lentille d'eau à trois lobes 	Lemna trisulca 	Lemnacées
Lentille d'eau minuscule 	Lemna minuta 	Lemnacée
Lentille d'eau petite 	Lemna minor 	Lemnacée
Lentille d'eau sans racines 	Wolffia arrhiza 	Lemnacées
Léotie visqueuse 	Leotia lubrica 	Leotiacées
Lépiote à crête 	Lepiota cristata 	Agaricacées
Lépiote brun incarnat 	Lepiota brunneoincarnata 	Agaricacées
Lépiote déguenillée 	Macrolepiota rhacodes 	Agaricacées
Lépiote mamelonnée 	Macrolepiota mastoidea 	Agaricacées
Lépiote pudique 	Leucoagaricus leucothites 	Agaricacées
Lépiote radicante 	Leucoagaricus macrorrhizus 	Agaricacées
Leuzée conifère 	Leuzea conifera 	Astéracées
Lewisia 	Lewisia cotylédone 	Portulaceae
Libocèdre 	Heyderia decurrens 	Cupressacées
Lichen gris des arbres 		
Lierre grimpant 	Hedera helix 	Araliacées
Lierre terrestre 	Glechoma hederacea 	Lamiacées
Lilas 	épis 	Oléacées
Lilas de Perse 	Melia azedarach 	Meliacées
Lilas des indes 	Lagerstroemia 	Des Lythraceae
Limodore à feuilles avortées 	limodorum abortivum 	Orchidacées
Limonium à feuilles cordées 	Limonium cordatum 	Plumbaginaceae
Limoselle aquatique 	Limosella aquatica 	Scrophulariacées
Lin à feuilles étroites 	Linum tenuifolium 	Linaceae
Lin bisannuel 	Linacées 	Linum bienne
Lin campanulé 	Linum Campanulatum 	Linaceae
Lin de Narbonne 	Linum narbonense 	Linacées
Lin des Alpes 	Linum alpinum 	Linacées
Lin purgatif 	Linum catharticum 	Linacées
Lin visqueux 	Linum viscosum 	Linaceae
Linaigrette à feuilles étroites 	Eriophorum angustifolium 	Cypéracées
Linaigrette des alpes 	Trichophorum alpinum 	Cypéracées
Linaigrette engainante 	Eriophorum vaginatum 	Cypéracées
Linaire à feuilles de thym 	Linaria thymifolia 	Scrophulariacées
Linaire à feuilles étroites 	Linaria angustissima 	Plantaginacées
Linaire améthyste 	Linaria amethystea 	Plantaginaceae (ex Scrophulariaceae)
Linaire bâtarde 	Linaria spuria 	Scrophulariacées
Linaire commune 	Linaria vulgaris 	Scrophulariacées
Linaire couchée 	Linaria supina 	Plantaginaceae
Linaire cymbalaire 	Cymbalaria muralis 	Scrophulariacées
Linaire des Alpes 	Linaria alpina 	Scrophulariacées
Linaire des sables 	Linaria arenaria 	Scrophulariacées
Linaire élatine 	Kickxia elatine 	Plantaginaceae (ex Scrophulariaceae)
Linaire grecque 	Kickxia commutata 	Scrophulariacées
Linaire simple 	Linaria simplex 	Plantaginaceae (ex Scrophulariaceae)
Linaire striée 	Linaria repens 	Scrfulariacées
Linaire visqueuse 	Linaria viscosa 	Plantaginaceae (ex Scrophulariaceae)
Linaire Vivace 	Lunaria Rediviva 	Crucifère
Linaire vulgaire 	Scrophulariacées 	Linaria vulgaris
Linée boréale 	Linnaea borealis 	Caprifoliacées
Liondent crépu 	Leontodon crispus 	Asteracées
Liondent d'Automne 	Leontodon automnalis 	Astéracées
Liondent des Pyrénées 	Leontodon pyrenaicus 	Astéracées
Liondent des rochers 	Leontodon saxatilis 	Asteraceae
Liondent faux-pissenlit 	Leontodon taraxacoides 	Astéracées
Liondent hispide 	Leontodon hispidus 	Astéracées
Lippie filiforme 	Phyla filiformis 	Verbenaceae
Lis 	Lilium 	Liliacées
Lis de saint Bruno 	Paradisea liliastrum 	Liliacées
Lis des Pyrénées 	Lilium pyraneicum 	Liliacées
Lis des sables 	Pancratium maritimum 	Amaryllidacées
Lis martagon 	Lilium martagon 	Liliacées
Lis nain 	Lilium pumilum 	Liliacées
Lis orangé 	Lilium bulbiferum 	Liliacées
Liseron des bois 	Calystegia sylvatica 	Convolvulacées
Liseron des Cantabriques 	Convolvulus cantabrica 	Convolvulacées
Liseron des champs 	Convolvulus arvensis 	Convolvulacées
Liseron des dunes 	Calystegia soldanella 	Convolvulacées
Liseron des haies 	Calystegia sepium 	Convolvulacées
Liseron fausse guimauve 	Convolvulus althaeoides 	Convolvulacées
Liseron laineux ou duveteux 	Convolvulus lanuginosus 	Convolvulacées
Listère en coeur 	Listera cordata 	Orchidacées
Listère ovale 	Listera ovata 	Orchidacées
Littorelle à une fleur 	Littorella uniflora 	Plantaginacées
Lloydie tardive 	Lloydia serotina 	Liliacées
Lobaria 		
Lobelia assurgens 	Lobelia assurgens 	Campanulacea
Lobélie brûlante 	Lobelia urens 	Lobéliacées
Lobulaire maritime 	Lobularia maritima 	Brassicacées
Lotier corniculé 	Lotus corniculatus 	Fabacées
Lotier des Alpes 	Lotus alpinus 	Fabacées
Lotier des marais 	Lotus uliginosus 	Fabacées
Lotier hérissé 	Lotus angustissimus ssp hispidus 	Fabacées
Lotier hirsute 	Lotus corniculatus subsp. valdepilosus 	Fabaceae
Lotier maritime 	Tetragonolobus maritimus 	Fabacées
Lotier pied-d'oiseau 	Lotus ornithopodioides 	Fabacées
Lotier pourpre 	Lotus tetragonolobus 	Fabacées
Lotus sacré d'Asie 	Nelumbo nucifera 	Nelumbonacées
Lunaire annuelle 	Lunaria annua - Lunaria rediviva 	Brassicacées
Lunaire vivace 	Lunaria rediviva 	Brassicacées
Lupin 	Lupinus polyphyllus 	Fabacées
Lupin à petites fleurs 	Lupinus micranthus 	Fabacées
Lupin jaune 	Lupinus luteus 	Fabacées
Luzerne à gousses en couronne 	Medicago coronata 	Fabaceae
Luzerne arborescente 	Medicago arborea 	Fabaceae
Luzerne bigarrée 	Medicago sativa media 	Fabacées
Luzerne cultivée 	Medicago sativa 	Fabaceae
Luzerne d'Arabie 	Medicago arabica 	Fabacées
Luzerne lupuline 	Medicago lupulina 	Fabacées
Luzerne maritime 	Medicago marina 	Fabacées
Luzerne orbiculaire 	Medicago orbicularis 	Fabacées
Luzerne polymorphe 	Medicago polymorpha 	Fabacées
Luzerne tronquée 	Medicago truncatula 	Fabacées
Luzule à fleurs nombreuses 	Luzula multiflora 	Juncacées
Luzule blanc de neige 	Luzula nivea 	Joncacées
Luzule changeante 	Luzula spicata subsp. mutalbilis 	Juncaceae
Luzule de Forster 	Luzula forsteri 	Joncacées
Luzule des bois 	Luzula maxima 	Joncacées
Luzule des champs 	Luzula campestris 	Joncacées
Luzule velue 	Luzula pilosa 	Joncacées
Lychnide fleur-de-coucou 	Lychnis flos-cuculis 	Caryophyllacées
Lychnide visqueuse 	Lychnis viscaria 	Caryophyllacées
Lychnis des Alpes 	Lychnis alpina 	Caryophyllacées
Lyciet commun 	Lycium barbarum 	Solanacées
Lycogale des arbres 	Lycogala epidendron 	Myxomicètes
Lycope d'Europe 	Lycopus europaeus 	Lamiacées
Lycopode à rameaux annuels 	Lycopodium annotinum 	Lycopodiacées
Lycopode inondé 	Lycopodiella inundata 	Lycopodiacées
Lys de Pompone 	Lilium pomponium 	Liliacées
Lysimaque commune 	Lysimachia vulgaris 	Primulacées
Lysimaque des bois 	Lysimachia nemorum 	Primulacées
Lysimaque nummulaire 	Lysimachia nummularia 	Primulacées
Lysimaque ponctuée 	Lysimachia punctata 	Primulaceae
Lysimaque terrestre 	Lysimachia terristris 	Primulacées
Lythrum à feuilles d'hysope 	Lythrum hyssopifolia 	Lythracées
Lythrum à feuilles de thym 	Lythrum thymifolium 	Lythraceae
Lythrum de Borysthene 	Lythrum borysthenicum 	Lythraceae
Maceron 	Smyrnium olusatrum 	Apiacées
Maceron perfolié 	Smyrnium perfoliatum 	Apiacées
Mâche sauvage 	Valerianella locusta 	Valérianacées
Macleaya 	Macleaya cordata 	Papavéracées
Mâcre 	Trapa natans 	Oenothéracées
Magnolia d'été 	Magnolia grandiflora 	Magnoliacées
Maianthème à deux feuilles 	Maianthemum bifolium 	Liliacées
Malcolmie à trois lobes 	Malcolmia triloba 	Brassicacées
Malcolmie très rameuse 	Malcolmia ramossissima 	Brassicaceae
Mandarinier 	Citrus nobilis 	Rutacées
Marasme à odeur d'ail 	Marasmius alliaceus 	Marasmiacées
Marasme des oréades 	Marasmius oreades 	Marasmiacées
Marguerite - Espèce cultivée 	Leuchanthemum vulgare 	Astéracées
Marguerite à feuilles en coin 	Leucanthemum cuneifolium 	Astéracée
Marguerite brûlée 	Leucanthemum adustum 	Asteraceae
Marguerite des Alpes 	Leucanthemopsis alpina 	Astéracées
Marguerite tomenteuse 	Leucanthemopsis tomentosa 	Astéracées
Marijuanilla 	Leonurus sibiricus 	Lamiaceae
Marronier rouge 	Aesculus X carnea 	HIPPOCASTANACEES
Marronnier d'Inde 	Aesculus hippocastanum 	Hippocastanacées
Marrube vulgaire 	Marrubium vulgare 	Lamiacées
Massette à larges feuilles 	Typha latifolium 	Typhacées
Massettes à feuilles étroites 	Typha angustifolia 	Typhacées
Matricaire inodore 	Matricariia perforata 	Astéracées
Matricaire odorante 	Matricaria discoidea 	Astéracées
Matthiole à fruit à trois cornes 	Matthiola tricuspidata 	Brassicacées
Maurelle 	Chrozophora tinctoria 	Euphorbiacées
Mauve à feuilles rondes 	Malva neglecta 	Malvacées
Mauve alcée 	Malva alcea 	Malvacées
Mauve d'Espagne 	Malva hispanica 	Malvacées
Mauve de Nice 	Malva nicaeensis All., 1785 	Malvaceae
Mauve des bois 	Malva sylvestris 	Malvacées
Mauve musquée 	Malva moschata 	Malvacées
Mauve musquée blanche 	Malva moschata alba 	Malvacées
Médéole de virginie 	Medeola virginiana 	Liliacées
Mélampyre à crêtes 	Melampyrum cristatum 	Scrophulariacées
Mélampyre des bois 	Melampyrum velebeticum 	Scrophulariacées
Mélampyre des champs 	Melampyrum arvense 	Scrophulariacées
Mélampyre des forêts 	Melampyrum sylvaticum 	Scrophulariacées
Mélampyre des prés 	Melampyrum pratense 	Scrophulariacées
Mélampyre du Dauphiné 	Melampyrum subalpinum 	Orobanchaceae
Mélèze d'Europe 	Larix decidua 	Pinacées
Mélèze du Japon 	Larix kaempferi 	Pinacées
Mélilot blanc 	Melilotus albus 	Fabacées
Mélilot officinal 	Melilotus officinalis 	Fabacées
Mélilot sillonné 	Melilotus sulcatus 	Fabaceae
Mélinet 	Cerinthe minor 	Boraginacées
Mélinet glabre 	Cerinthe glabra 	Boraginacées
Mélique à une fleur 	Melica uniflora 	Poacées
Mélique ciliée 	Melica ciliata L., 1753 	Poaceae
Mélisse de Moldavie 	Dracocephalum moldavicum 	Lamiacées
Mélisse officinale 	Melissa Officinalis 	Lamiacées
Mélitte à feuilles de mélisse 	Melittis melissophyllum 	Lamiacées
Menthe à feuilles rondes 	Mentha suaveolens 	Lamiacées
Menthe à longues feuilles 	Mentha longifolia 	Lamiacées
Menthe aquatique 	Mentha aquatica 	Lamiacées
Menthe Citron 	Mentha citrata 	Lamiacées
Menthe des cerfs 	Mentha cervina 	Lamiacées
Menthe des champs 	Mentha arvensis 	Lamiacées
Menthe en épi 	Mentha spicata 	Lamiaceae
Menthe Pouliot 	Mentha pulegium 	Lamiacées
Mercuriale annuelle 	Mercurialis annua 	Euphorbiacées
Mercuriale pérenne 	Mercurialis perennis 	Euphorbiacées
Mercuriale tomenteuse 	Mercurialis tomentosa 	Euphorbiacées
Mérendère à feuilles filiformes 	Merendera filifolia 	Liliacées
Merisier 	Prunus avium 	Rosacées
Mibore printanière 	Mibora minima 	Poacées
Micocoulier 	Celtis australis 	Cannabacées
Micromérie de Grèce 	Micromeria graeca 	Lamiacées
Micromérie marginée 	Micromeria marginata 	Lamiaceae
Millepertuis à feuilles de linaire 	Hypericum linarifolium 	Hypéricacées
Millepertuis à feuilles rondes 	Hypericum nummularium 	Hypericaceae
Millepertuis à quatre angles 	Hypericum tetrapterum 	Hypéricacées
Millepertuis commun 	Hypericum perforatum 	Guttifères
Millepertuis couché 	Hypericum humifusum 	Hypéricacées
Millepertuis des marais 	Hypericum elodes 	Hypéricacées
Millepertuis des montagnes 	Hypericum montanum 	Hypéricacées
Millepertuis élégant 	Hypericum pulchrum 	Guttifères
Millepertuis tacheté 	Hypericum maculatum 	Hypericacées
Millepertuis velu 	Hypericum hirsutum 	Hypéricacées
Millet des oiseaux 	Setaria italica 	Poacées
Millet diffus 	Milium effusum 	Poacées
Millet scabre 	Milium vernale subsp. scabrum 	Poaceae
Mimosa d'hiver 	Acacia dealbata 	Fabacées
Mimule tacheté 	Mimulus guttatus 	Scrophulariacées
Minuartie à feuilles de mélèze 	Minuartia laricifolia 	Caryophyllacées
Minuartie à rostre 	Minuartia rostrata 	Caryophyllaceae
Minuartie de Clément 	Minuartia rupestris subsp. clementei 	Caryophyllaceae
Minuartie des rochers 	Minuartia rupestris subsp. rupestris 	Caryophyllaceae
Minuartie intermédiaire 	Minuartia hybrida 	Caryophyllacées
Miroir de Vénus 	Legousia speculum-veneris 	Campanulacées
Misère pourpre 	Tradescantia pallida 	Commélinacées
Mitchella rampant 	Mitchella repens 	Rubiacées
Moehringie faux sédum 	Moehringia sedoides 	Caryophyllaceae
Moehringie mousse 	Moehringia muscosa 	Caryophyllacées
Molène blattaire 	Verbascum blattaria 	Scrophulariacées
Molène de Mai 	Verbascum boerhavii 	Scrophulariacées
Molène faux-bouillon blanc 	Verbascum densiflorum 	Scrophulariacées
Molène floconneuse 	Verbascum pulverulentum 	Scrophulariacées
Molène lychnite 	Verbascum lychnitis 	Scrophulariacées
Molène noire 	Verbascum nigrum 	Scrophulariacées
Molène sinuée 	Verbascum sinuatum 	Scrophulariacées
Molène thapsus 	Verbascum thapsus 	Scrophulariacée
Molucelle 	Molucella 	Labiacée/ lamiacée
Monarde didyma 	Monarda didyma 	Lamiacées
Monotrop suce-pin 	Monotropa hypopytis 	Pyrolacées
Monotrope uniflore 	Monotropa uniflora 	Ericacées
Montie des fontaines 	Montia fontana 	Portulacaceae
Morelle douce-amère 	Solanum dulcamara 	Solanacées
Morelle noire 	Solanum nigrum 	Solanacées
Morelle velue 	Solanum villosum 	Solanacées
Morille comestible 	Morchella esculenta 	Morchellacées
Morille conique 	Morchella elata 	Morchellacées
Morille des jardins 	Morchella hortensis 	Morchellacées
Morillon 	Mitrophora semilibera 	Morchellacées
Morisie à une fleur 	Morisia monanthos 	Brassicacées
Moschatelline 	Adoxa moschatellina 	Adoxacées
Mouron bleu 	Anagalis foemina 	Primulacées
Mouron d'eau 	Samolus valerandi 	Primulacées
Mouron délicat 	Anagallis tenella 	Primulacées
Mouron des champs 	Anagallis arvensis 	Primulacées
Mouron des oiseaux 	Stellaria media 	Caryophyllacées
Mouron nain 	Anagallis minima 	Primulacées
Moutarde des champs 	Sinapsis arvensis 	Crucifère
Moutarde des oiseaux 	Brassica rapa 	Cruciféracées
Moutarde giroflée 	Coincya monensis 	Cruciféracées
Mucidule visqueuse 	Oudemansiella mucida 	Trichomatales
Muflier - Espèces cultivées 	Antirrhinum majus 	Srophulariacea
Muflier à feuilles de pâquerette 	Anarrhinum bellidifolium 	Scrophulariacées
Muflier des champs 	Misopates orontium 	Scrophulariacées
Muguet de mai 	Convallaria maialis 	Liliacées
Murier blanc 	Morus alba 	Moracées
Murier noir 	Morus nigra 	Moracées
Mûrier platane 	Morus kagayamae 	Moracées
Muscari à toupet 	Muscari comosum 	Liliacées
Muscari capelan 	Muscari neglectum 	Liliacées
Mycène en casque 	Mycena galericulata 	Marasmiacées
Mycène gris brun 	Mycena aetites 	Marasmiacées
Mycène pure 	Mycena pura 	Marasmiacées
Myoporum ou Arbre de Ngaio 	Myoporum laetum 	Scrophulaceae
Myosotis alpestre 	Myosotis alpestris 	Boraginacées
Myosotis bicolore 	Myosotis discolor 	Boraginacées
Myosotis des bois 	Myosotis sylvatica 	Boraginaceae
Myosotis des champs 	Myosotis arvensis 	Boraginacées
Myosotis des forêts 	Myosotis sylvatica 	Boraginacées
Myosotis des marais 	Myosotis scorpioides 	Boraginacées
Myosotis étalé 	Myosotis decumbens 	Boraginaceae
Myosotis hérissé 	Myosotis ramosissima 	Boraginacées
Myosoton aquatique 	Myosoton aquaticum 	Caryophillacées
Myricaire d'Allemagne 	Myricaria germanica 	Tamaricacées
Myriophylle à épis 	Myriophyllum spicatum 	Haloragacées
Myriophylle à fleurs alternes 	Myriophyllum alterniflorum 	Haloragacées
Myriophylle du Brésil 	Myriophyllum brasilense 	Haloragacées
Myrte 	Myrtus communis 	Myrtacées
Myrte à petites feuilles 	Myrtus communis ssp tarentina 	Myrtacées
Myrtille 	Vaccinium myrtillus 	Ericacées
Naïade marine 	Najas marina 	Naïadacées
Nananthée naine 	Nananthea perpusilla 	Asteraceae
Narcisse à fleur rayonnante 	Narcissus radiiflorus 	Amaryllidacées
Narcisse bulbocodium 	Narcissus bulbocodium 	Amaryllidacées
Narcisse d'Asso 	Narcissus assoanus 	Amaryllidacées
Narcisse d'automne 	Narcissus serotinus 	Amaryllidacées
Narcisse des Glénans 	Narcissus triandrus subsp capax 	Amaryllidacées
Narcisse des poètes 	Narcissus poeticus 	Amaryllidacées
Narcisse douteux 	Narcissus dubius 	Amaryllidaceae
Narcisse tazette 	Narcissus tazetta 	Amaryllidaceae
Nard raide 	Nardus stricta 	Poacées
Narthécie de Reverchon 	Narthecium reverchonii 	Liliacées
Narthécie ossifrage 	Narthecium ossifragum 	Liliacées
Néflier 	Mespilus germanica 	Rosacées
Nénuphar blanc 	Nymphaea alba 	Nymphéacées
Nénuphar jaune 	Nuphar lutea 	Nynphaeacées
Nénuphare 	Nymphaea 	Nympheacées
Neotine tachetée 	Neotinea maculata 	Orchidacées
Néottie à feuilles ovales 	Neottia ovata 	Orchidacées
Néottie nid d'oiseau 	Neottia nidus avis 	Orchidacées
Népéta petit népéta 	Nepeta nepetella 	Lamiacées
Nerprun alaterne 	Rhamnus alaternus 	Rhamnacées
Nerprun des Alpes 	Rhamnus alpinus 	Rhamnacées
Nerprun nain 	Rhamnus pumila 	Rhamnacées
Nerprun purgatif 	Rhamnus catharticus 	Rhamnacées
Nertera 	Nertera granadensis 	Rubiacées
Nielle des blés 	Agrostemma githago 	Caryophyllacées
Nielle frêle 	Agrostemma gracile 	Caryophyllaceae
Nigelle de Damas 	Nigella damascena 	Renonculacées
Nigritelle de corneli 	Gymnadenia corneliana 	Orchidacées
Nigritelle noire 	Gymnadenia rhellicani 	Orchidacées
Nivéole 	Leucojum vernum 	Amaryllidacées
Nivéole à feuilles fines 	Leucoium trichophyllum Schousb. 	Amaryllidacées
Nivéole à feuilles longues 	Leucoium longifolium 	Amaryllidaceae
Nivéole à feuilles très étroites 	Leucojum trichophyllum 	Amaryllidacées
Nivéole d'été 	Leucojum aestivum 	Amaryllidacées
Nivéole de Nice 	Leucojum nicaeense 	Amaryllidacées
Noisetier 	Corylus avellana 	Corylacées
Noisetier à long bec 	Corylus cornuta 	Bétulacées
Nombril de Vénus 	Umbilicus rupestris 	Crassulacées
Nonette voilée 	Suillus luteus 	Boletacées
Notholæne de Maranta 	Paragymnopteris marantae subsp. subcordata 	Polypodiaceae
Noyer commun 	Juglans regia 	Juglandacées
Noyer noir 	Juglans nigra 	Juglandacées
Nymphoïde Flocon de neige 	Nymphoides indica 	Ményanthacées
Obione faux-pourpier 	Halimione portulacoïdes 	Chénopodiacées
Odontite glutineux 	Odontites glutinosus 	Orobanchaceae
Odontite jaune 	Odontites luteus 	Scrophulariacées
Odontite tardif 	Odontites vernus subsp serotinus 	Scrofulariaceae
Œillet à tiges courtes 	Dianthus subacaulis 	Caryophyllacées
Oeillet barbu 	Dianthus barbatus 	Caryophyllacées
Oeillet de Balbis 	Dianthus balbisii 	Asteraceae
Oeillet de Chine 	Dianthus sinensis 	Caryophyllacées
Oeillet de dieu 	Silene flor jovis 	Caryophillacées
Oeillet de Montpellier 	Dianthus hyssopifolius 	Caryophyllacées
Oeillet des Chartreux 	Dianthus carthusianorum 	Caryophyllacées
Oeillet du granite 	Dianthus graniticus 	Caryophyllacées
Oeillet en delta 	Dianthus deltoides 	Caryophyllacées
Oeillet fourchu 	Dianthus furcatus 	Caryophyllaceae
Oeillet mignardise 	Dianthus plumarius 	Caryophyllacées
Oeillet négligé 	Dianthus neglectus 	Caryophyllacées
Oeillet oeil de paon 	Dianthus pavonius 	Caryophyllacées
Oeillet prolifère 	Petrorhagia prolifera 	Caryophyllacées
Oeillet sauvage 	Dianthus saxicola 	Caryophyllacées
Oeillet superbe 	Dianthus superbus 	Caryophyllacées
Oeillet sylvestre 	Dianthus seguieri subsp. pseudocollinus 	Caryophyllaceae
Oeillet velu 	Dianthus armeria 	Caryophyllacées
Oeillet virginal 	Dianthus virgineus 	Caryophyllacées
Oenanthe globuleuse 	Oenanthe globulosa 	Apiaceae
Oenanthe safranée 	Oenanthe crocata 	Ombellifères
Olivier 	Olea europaea 	Oléacées
Onagre à grandes fleurs 	Oenothera erythrosepala 	Onagracées
Onagre bisanuelle 	Oenothera biennis 	Onagracées
Onagre de Glaziou 	Oenanthera glazioviana - Micheli 	Onagracées
Onagre rose 	Oenothera speciosa 	Onagracées
Onagre Velue 	Oenothera villosa 	Onagraceae
Onoclée sensible 	Onoclea sensibilis 	Polypodiacées
Ononis de Cosson 	Ononis cossoniana 	Fabacées
Ophioglosse des Açores 	Ophioglossum azoricum 	Ophioglossacées
Ophioglosse du Portugal 	Ophioglossum lusitanicum 	Ophioglossaceae
Ophrys à deux lunules 	Ophrys bilunulata 	Orchidaceae
Ophrys abeille 	Ophrys apifera 	Orchidacées
Ophrys araignée 	Ophrys aranifera 	Orchidacées
Ophrys bécasse 	Ophrys scolopax 	Orchidacées
Ophrys bombyx 	Ophrys bombyliflora 	Orchidaceae
Ophrys bourdon 	Ophrys fuciflora 	Orchidacées
Ophrys d'Aymonin 	Ophrys aymoninii 	Orchidaceae
Ophrys de Bertoloni 	Ophrys bertolonii 	Orchidacées
Ophrys de Corse 	Ophrys corsica 	Orchidacées
Ophrys de Forestier 	Ophrys forestieri 	Orchidaceae
Ophrys de la Drôme 	Ophrys drumana 	Orchidacées
Ophrys de la passion 	Ophrys passionis 	Orchidacées
Ophrys de Marseille 	Ophrys massiliensis 	Orchidaceae
Ophrys de Philippe 	Ophrys philippii 	Orchidacées
Ophrys de Provence 	Ophrys provincialis 	Orchidaceaae
Ophrys des Lupercales 	Ophrys lupercalis 	Orchidacées
Ophrys fausse araignée 	Ophrys arachnitiformis 	Orchidacées
Ophrys fausse bécasse 	Ophrys pseudoscolopax 	Orchidaceae
Ophrys jaune 	Ophrys lutea 	Orchidacées
Ophrys miroir 	Ophrys speculum (ciliata) 	Orchidaceae
Ophrys mouche 	Ophrys insectifera 	Orchidacées
Ophrys noir 	Ophrys incubacea 	Orchidacées
Ophrys petite araignée 	Ophrys araneola 	Orchidacées
Ophrys sphegodes 	Ophrys sphegodes 	Orchidacées
Ophrys splendide 	Ophrys splendida 	Orchidacées
Ophrys verdissant 	Ophrys virescens 	Orchidaceae
Opoponax de Chiron 	Opoponax chironium 	Apiacées
Oranger 	Citrus sinensis 	Rutacées
Oranger des osages 	Maclura pomifera 	Moraceae
Oranger du mexique 	Choisya ternata 	RUTACEES
Orcanette d'orient 	Alkanna orientalis 	Boraginacées
Orcanette des sables 	Onosma arenaria 	Borraginacea
Orcanette des teinturiers 	Alkanna matthioli 	Boraginacées
Orcanette fastigiée 	Onosma echioides 	Boranigaceae
Orchidée 	orchis 	Orchidacées
Orchis à fleurs lâches 	Orchis laxiflora 	Orchidacées
Orchis à longue corne 	Anacamptis longicornu 	Orchidacées
Orchis à longues bractées 	Himantoglossum robertianum 	Orchidacées
Orchis à trois dents 	Orchis tridentata 	Orchidacées
Orchis bouc 	Himantoglossum hircinum 	Orchidacées
Orchis bouffon 	Anacamptis morio 	Orchidacées
Orchis brûlé 	Orchis ustulata 	Orchidacées
Orchis de Champagneux 	Anacamptis champagneuxii 	Orchidaceaae
Orchis de Fuchs 	Dactylorhiza Fuchsii 	Orchidacées
Orchis de Provence 	Orchis provincialis 	Orchidaceaae
Orchis de Von Spitzel 	Orchis spitzelii 	Orchidacées
Orchis des îles d'Hyères 	Orchis olbiensis 	Orchidacées
Orchis globuleux 	Traunsteinera globosa 	Orchidacées
Orchis grenouille 	Dactylorhiza viridis 	Orchidacées
Orchis homme-pendu 	Orchis anthropophora 	Orchidacées
Orchis incarnat 	Dactylorhiza incarnata 	Orchidacées
Orchis laiteux 	Neotinea lactea 	Orchidaceae
Orchis mâle 	Orchis mascula 	Orchidacées
Orchis miel 	Pseudoorchis albida 	Orchidacées
Orchis militaire 	Orchis militaris 	Orchidacées
Orchis moucheron 	Gymnadenia conopsea 	Orchidacées
Orchis musc 	Herminium monorchis 	Orchidacées
Orchis nain des Alpes 	Chamorchis alpina 	Orchidacées
Orchis négligé 	Dactylorhiza praetermissa 	Orchidacées
Orchis odorant 	Gymnadenia odoratissima 	Orchidacées
Orchis ovale 	Orchis ovalis 	Orchidacées
Orchis pâle 	Orchis pallens 	Orchidacées
Orchis papillon 	Anacamptis papilionacea subsp. papilionacea 	Orchidaceaae
Orchis parfumé 	Anacamptis fragrans 	Orchidaceae
Orchis peint 	Anacamptis morio subsp. picta 	Orchidaceaae
Orchis pourpre 	Orchis purpurea 	Orchidacées
Orchis punaise 	Anacamptis coriophora 	Orchidacées
Orchis pyramidale 	Anacamptis pyramidalis 	Orchidacées
Orchis singe 	Orchis simia 	Orchidacées
Orchis sureau 	Dactylorhiza sambucina 	Orchidacées
Orchis tacheté 	Dactylorhiza maculata 	Orchidacées
Orchis vanille 	Nigritella rhellicani 	Orchidacées
Orchis verdâtre 	Platanthera chloranta 	Orchidacée
Oreille d'élèphant 	Alocasia macrorrhiza 	Aracées
Oreille de cochon ; pour les anglais Pig'ear 	Cotyledon macrantha; cotyledon orbiculata 	Crassulaceaea
Oreille de Judas 		
Orge des rats 	Hordeum murinum 	Poacées
Origan 	Origanum vulgare 	Lamiacées
Origan en épi 	Origanum vulgare var. macrostachyum 	Lamiaceae
Orlaya à grandes fleurs 	Orlaya grandiflora 	Apiacées
Orme champêtre 	Ulmus minor 	Ulmacées
Orme de montagne 	Ulmus glabra 	Ulmacées
Orme lisse 	Ulmus laevis 	Ulmacées
Ornithogale à feuilles filiforme 	Ornithogalum gussonei Ten. 	Asparagaceae
Ornithogale de Narbonne 	Loncomelos narbonense 	Asparagacées
Ornithogale des Pyrénées 	Loncomelos pyrenaicum 	Asparagacées
Ornithogale en ombelle 	Ornithogalum umbellatum 	Liliacées
Orobanche commune 	Orobanche caryophyllacea 	Orobanchacées
Orobanche de Germandrée 	orobanche teucrii 	orobanchaceae
Orobanche du lierre 	Orobanche hederae 	Orobanchacées
Orobanche du thym 	Orobanche alba 	Orobanchées
Orobanche du trèfle 	Orobanche minor 	Orobanchacées
Orobanche fétide 	Orobanche foetida 	Orobanchacées
Orobanche gracile (cruelle) 	Orobanche gracilis 	Orobanchaceae
Orobanche jaune 	Orobanche lutea 	Orobanchacées
Orpin à feuilles épaisses 	Sedum dasyphyllun 	Crassulacées
Orpin à pétales dressés 	Sedum anopetalum 	Crassulaceae
Orpin âcre 	Sedum acre 	Crassulacées
Orpin blanc 	Sedum album 	Crassulacées
Orpin bleu 	Sedum anacampseros 	Crassulacées
Orpin d'Angleterre 	Sedum anglicum 	Crassulacées
Orpin de Foster 	Sedum Fosterianum 	Crassulaceae
Orpin de montagne 	Sedum montanum 	Crassulacées
Orpin de Nice 	Sedum sediforme 	Crassulacées
Orpin des rochers 	Sedum rupestre 	Crassulaceae
Orpin doux 	Sedum sexangulare 	Crassulacées
Orpin du mont Royal 	Sedum monregalense 	Crassulaceae
Orpin hérissé 	Sedum hirsutum 	Crassulacées
Orpin noirâtre 	Sedum atratum 	Crassulacées
Orpin parfumé 	Sedum fragans 	Crassulaceae
Orpin pourpier 	Sedum cepaea 	Crassulacées
Orpin réfléchi 	Sedum reflexum 	Crassulacées
Orpin reprise 	Sedum telephium 	Crassulacées
Ortie à pilules 	Urtica pilulifera 	Urticacées
Ortie brûlante 	Urtica urens 	Urticacées
Ortie dioïque 	Urtica dioica 	Urticacées
Ortie Dioïque ou Grande Ortie 	Urtica dioica L 	Urticaceae
Oseille 	Rumex acetosa 	Polygonacées
Oseille à écussons 	Rumex scutatus 	Polygonacées
Osmonde royale 	Osmunda regalis 	Osmondacées
Ostrya 	Ostrya carpinifolia 	Betulacées
Osyris blanc 	Osyris alba 	Santalacées
Oxalide d'Europe 	Oxalis stricta 	Oxalidacées
Oxalide petite oseille 	Oxalis acetosella 	Oxalidacées
Oxalis à larges feuilles 	Oxalis latifolia Kunth 	Oxalidacées
Oxalis articulée 	Oxalis articulata 	Oxalidacées
Oxalis corniculé 	Oxalis corniculata 	Oxalidacées
Oxalis pied de chèvre 	Oxalis pes-caprae 	Oxalidaceae
Oxyrie à deux stigmates 	Oxiria digyna 	Polygonacées
Oxytropide de Suisse 	Oxytropis helvetica 	Fabacées
Oxytropis des Alpes 	Oxytropis campestris 	Fabacées
Paliure 	Paliurus spina-christis 	Rhamnacées
Palmier nain 	Chamaerops humilis 	Arecaceae
Pamier 	Ne sait pas 	Palmier
Panais 	Pastinaca sativa 	Apiacées
Panais épineux 	Echinophora spinosa 	Apiacées
Pancratium d'Illyrie 	Pancratium illyricum 	Amaryllidacées
Panic capillaire 	Panicum capillare 	Poacées
Panic des marais 	Echinochloa crus-galli 	Poacées
Panicaut blanche épine 	Eryngium spinalba 	Apiacées
Panicaut champêtre 	Eryngium campestre 	Apiacées
Panicaut des Alpes 	Eryngium alpinum 	Apiacées
Panicaut maritime 	Eryngium maritimum 	Apiacées
Panzeria 	Panzeria canescens 	Lamiacées
Pâquerette 	Bellis perennis 	Astéracées
Pariétaire de Judée 	Parietaria judaica 	Urticacées
Parietaire du Portugal 	Parietaria lusitanica 	Urticaceae
Pariétaire officinale 	Parietaria officinalis 	Urticacées
Parisette 	Paris quadrifolia 	Liliacées
Parmelia 		
Parnassie des marais 	Parnassia palustris 	Parnassiacées
Paronique de France 	Paronychia kapela galloprovincialis 	Caryophylacées
Paronique en cyme 	Chaetonychia cymosa 	Caryophyllaceae
Paronyque argentée 	Paronychia argentea 	Caryophyllacées
Paspale dilaté 	Paspalum dilatatum 	Poacées
Paspale dilatée 	Paspalum dilatatum 	Poacées
Passerage à feuilles de graminée 	Lepidium graminifolium 	Brassicacées
Passerage à fleurs denses 	Lepidium densiflorum 	Brassicacées
Passerage de Smith 	Lepidium heterophyllum 	Brassicacées
Passerage des champs 	Lepidium campestre 	Brassicacées
Passerage drave 	Lepidium draba 	Brassicacées
Passerine hirsute 	Thymelaea hirsuta 	Thyméléacées
Passerine tartonraire 	Thymelaea tartonraira 	Thymelaeacées
Passerine thymélée, herbe du mont Serrat 	Thymelea sanamunda 	Thymeleaceae
Passiflore 	Passiflora 	Passifloraceae
Pastel des teinturiers 	Isatis tinctoria 	Brassicacées
Patience à feuilles obtuses 	Rumex obtusifolius 	Polygonaceae
Patience agglomérée 	Rumex conglomeratus 	Polygonacées
Patience crépue 	Rumex crispus 	Polygonacées
Patience d'eau 	Rumex hydrolapathum 	Polygonacées
Patience de Tanger 	Rumex roseus 	Polygonaceae
Patience domestique 	Rumex longifolius 	Polygonaceae
Patience élégante 	Rumex pulcher 	Polygonacées
Patience maritime 	Rumex maritimus 	Polygonacées
Patience sanguine 	Rumex sanguineus 	Polygonacées
Pâturin annuel 	Poa annua 	Poacées
Pâturin bulbeux 	Poa bulbosa 	Poacées
Pâturin commun 	Poa trivialis 	Poacées
Pâturin des bois 	Poa nemoralis 	Poacées
Pâturin grêle 	Poa infirma 	Poacées
Paulownia impérial 	Paulownia tomentosa 	SCROFULARIACEES
Pavot argemone 	Papaver argemone 	Papavéracées
Pavot cornu 	Glaucium flavum 	Papavéracées
Pavot d'orient 	Papaver 	Papaveracées
Pavot du Pays de Galles 	Meconopsis cambrica 	Papavéracées
Pavot en arbre 	Romneya coulteri 	Papaveraceae
Pavot orangé 	Papaver rhaeticum 	Papavéracées
Pavot somnifère 	Papaver somniferum 	Papaveraceae
Paxille enroulé 	Paxillus involutus 	Paxillacées
Pêcher 	Prunus persica 	Rosacées
Pédculaire du Mont Cenis 	Pedicularis cenisia 	Scrophulariacées
Pédiculaire à bec et en épi 	Pedicularis rostratospicata 	Orobanchacées
Pédiculaire arquée 	Pedicularis gyroflexa 	Scrophulariacées
Pédiculaire ascendante 	Pedicularis ascendens 	Scrophulariacées
Pédiculaire chevelu 	Pedicularis comosa 	Orobanchaceae
Pédiculaire de Kerner 	Pedicularis kerneri 	Scrophulariacées
Pédiculaire des bois 	Pedicularis sylvatica 	Scrophulariacées
Pédiculaire des marais 	Pedicularis palustris 	Scrophulariacées
Pédiculaire des Pyrénées 	Pedicularis pyrenaica 	Scrophulariacées
Pédiculaire feuillée 	Pedicularis foliosa 	Scrophulariacées
Pédiculaire verticillé 	Pedicularis verticillata 	Scrophulariacées
Pensée à deux fleurs 	Viola biflora 	Violacées
Pensée calaminaire 	Viola calaminaria 	Violacées
Pensée de Kitaibel 	Viola kitaibeliana Schult., 	Violaceae
Pensée des Alpes 	Viola calcarata 	Violacées
Pensée des champs 	Viola arvensis 	Violacées
Pensée des champs à grandes fleurs 	Viola arvensis subsp. megalantha 	Violaceae
Pensée du Mont Cenis 	Viola Cenisia 	Violacées
Pensée jaune 	Viola lutea 	Violaceae
Pensée sauvage 	Viola tricolor 	Violacées
Péplis faux-pourpier 	Lythrum portula 	Lythracées
Perce neige 	Galanthus nivalis 	Amaryllidacées
Perovskia 	Perovskia 	Lamiacées
Persicaire 	Persicaria maculosa Gray 	Polygonaceae
Persil de montagne 	Peucedanum oreoselinum 	Apiacées
Persil des Cerfs 	Oreoselinum nigrum 	Asteraceae
Persil sauvage 	Anthriscus sylvestris 	Apiacées
Pesse d'eau 	Hippurus vulgaris 	Hippuridacées
Pétasite blanc 	Petasites albus 	Astéracées
Pétasite hybride 	Petasites hybridus 	Astéracées
Petit boucage 	Pimpinella saxifraga 	Apiacées
Petit Calament 	Calamintha nepeta 	Lamiacées
Petit nard délicat 	Micropyrum tenllum 	Poacées
Petit nénuphar 	Hydrocharis morsus-ranae 	Hydrocharitacées
Petit papyrus 	Cyperus eragrostis 	Cyperacées
Petit Rhinanthe 	Rhinanthus minor 	Scrophulariacée
Petit solidage 	Solidago virgaurea subsp. alpestris 	Asteraceae
Petit Tamarin des Hauts 	Sophora denudata 	Fabaceae
Petit Thé 	Gaultheria hispidula 	Ericacées
Petite Astrance 	Astrantia minor 	Apiacées
Petite Bardane 	Arctium minus 	Astéracées
Petite centaurée commune 	Centaurium erythraea 	Gentianacées
Petite centaurée fausse scille 	Centaurium scilloides 	Gentianacées
Petite centaurée maritime 	Centaurium maritimum 	Gentianacées
Petite ciguë 	Aethusa cynapium 	Apiacées
Petite linaire 	Chaenorrhinum minus 	Scrophulariacées
Petite luzerne 	Medicago minima 	Fabaceae
Petite massette 	Typha minima 	Typhacées
Petite naïade 	Najas minor 	Naïadacées
Petite oseille 	Rumex acetosella 	Polygonacées
Petite pervenche 	Vinca minor 	Apocynacées
Petite pimprenelle 	Sanguisorba minor 	Rosacées
Petite Pyrole 	Pyrola minor 	Pyrolacées
Petite Renouée 	Polygonum minus 	Polygonacées
Petite Scutellaire 	Scutellaria minor 	Lamiacées
Petite-centaurée délicate 	Centaurium pulchellum subsp. pulchellum 	Gentianaceae
Pétrocalle des Pyrénées 	Petrocallis pyrenaica 	Brassicacées
Peucédan de Schott 	Peucedanum schottii 	Apiaceae
Peuplier blanc 	Populus alba 	Salicacées
Peuplier noir 	Populus nigra 	Salicacées
Pézize baie 	Peziza badia 	Pézizacées
pezize coccinéa 	Sarcoscypha coccinéa 	Pézize
Pezize orangée 	Aleuria aurantia 	Pezizacées
Pezize veinée 	Disciotis venosa 	Morchellacées
Phacélie à feuilles de tanaisie 	Phacelia tanacetifolia 	Hydrophyllacées
Phagnalon des rochers 	Phagnalon saxatile 	Asteracées
Phagnalon sordide 	Phagnalon sordidum 	Asteracées
Phalangère à fleur de lys 	Anthericum liliago 	Liliacées
Phalangère rameuse 	Anthericum ramosum 	Liliacées
Phléole des prés 	Phleum pratense 	Poacées
Phlomis herbe au vent 	Phlomis herba venti 	Lamiaceae
Phlomis pourpre 	Phlomis purpurea 	Lamiacées
Pholiote changeante 	Kuehneromyces mutabilis 	Strophariacées
Pholiote destructrice 	Hemipholiota polpunea 	Strophariacées
Pholiote du peuplier 	Agrocybe aegerita 	Bolbitiacées
Pholiote écailleuse 	Pholiota squarrosa 	Strophariaceae
Pholiote ridée 	Rozites caperatus 	Cortinariacées
Phyllopore d'Europe 	Phylloporus pelletieri 	Boletacées
Phymosia 	Phymosia 	Malvacées
Picride fausse-épervière 	Picris hieracoides 	Astéracées
Picride fausse-vipérine 	Picris echioides 	Astéracées
Pied bleu 	Lepista nuda 	Tricholomatacées
Pied d'alouette pubescent 	Consolida pubescens 	Ranunculaceae
Pied d'élèphant 	Beaucarnea recurvata 	Agavacées
Pied d'oiseau à fruits cornus 	Ornithopus sativus subsp. isthmocarpus 	Fabacées
Pied de coq 	Equinochloa crus-galli 	Poacées
Pied de mouton orangé 	Hydnum rufescens 	Hydnacées
Pied violet 	Lepista saeva 	Tricholomatacées
Pied-de-mouton 	Hydnum repandum 	Hydnacées
Pièris japonica 	Piéris 	Éricacées
Pigamon à feuilles d'ancolie 	Thalictrum aquilegifolium 	Renonculacées
Pigamon jaune 	Thalictrum flavum 	Renonculacée
Piloselle de Lepèletier 	Pilosella peleteriana 	Asteracées
Piloselle gazonnante 	Hieracium caespitosum 	Asteraceae
Pilulaire à globules ou boulettes d'eau 	Pilularia globulifera 	Marsiléacées
Pimprenelle épineuse 	Sarcopoterium spinosum 	Rosacées
Pin à cinq aiguilles 	Pinus pentaphylla 	Pinacee
Pin à crochets 	Pinus uncinata 	Pinacées
Pin cembro 	Pinus cembra 	Pinacées
Pin d'alep 	Pinus halepensis 	Pinacées
Pin de Monterey 	Pinus radiata 	Pinacées
Pin de Murray 	Pinus contorta 	Pinacées
Pin de Salzmann 	Pinus nigra salzmanni 	Pinacées
Pin de Wollemi 	Wollemia nobilis 	Araucariacées
Pin laricio de Calabre 	Pinus nigra laricio calabrica 	Pinacées
Pin laricio de Corse 	Pinus nigra laricio corsicana 	Pinacées
Pin maritime 	Pinus pinaster 	Pinacées
Pin mugo 	Pinus mugo 	Pinacées
Pin noir d'Autriche 	Pinus nigra nigra 	Pinacées
Pin pinier 	Pinus pinea 	Pinacées
Pin sylvestre 	Pinus sylvestris 	Pinacées
Pin Weymouth 	Pinus strobus 	Pinacées
Pissenlit officinal 	Taraxacum officinale 	Astéracées
Pistachier lentisque 	Pistacia leniscus 	Anacardiacées
Pistachier térébinthe 	Pistacia terebinthus 	Anacardiacées
Pittospore 	Pittosporum heterophyllum 	Pittosporacées
Pittospore odorant 	Pittosporum tobira 	Pittosporacées
Pivoine 	Paeonia 	Péonacées
Pivoine de Russo 	Paeonia mascula subsp. russoi 	Paeoniaceae
Pivoine officinale 	Paeonia officinalis 	Paeoniacées
Plantain corne-de-cerf 	Plantago coronopus 	Plantaginacées
Plantain d'eau 	Alisma plantago-aquatica 	Alismacées
Plantain d'eau lancéolé 	Alisma lanceolatum 	Alismatacées
Plantain des Alpes 	Plantago alpina 	Plantaginacées
Plantain des sables 	Plantago scabra 	Plantaginacées
Plantain lancéolé 	Plantago lanceolata 	Plantaginacées
Plantain moyen 	Plantago media 	Plantaginacées
Plantain noirâtre 	Plantago atrata 	Plantaginacées
Plantain pied-de-lièvre 	Plantago lagopus 	Plantaginaceae
Plantain pucier 	Plantago afra 	Plantaginaceae
Plantain serpentin 	Plantago maritima subsp. serpentina 	Plantaginacées
Plantain toujours vert 	Plantago sempervirens 	Plantaginacées
Plante caméléon 	Houttuynia cordata 	Saururacées
Plante ZZ 	Zamioculcas zamiifolia 	Aracée
Platane 	Platanus hybrida 	Platanacées
Platanthère à deux feuilles 	Platanthera bifolia 	Orchidacées
Platanthère à fleurs vertes 	Platanthera chlorantha 	Orchidacées
Plectranthus coleoides 	Plectranthus coleoides 	Lamiacées
Plectrantus purpurea 	Plectrantus 	Plectrantus
Pleurote corne d'abondance 	Pleurotus cornucopiae 	Pleurotacées
Pleurote en forme d'huître 	Pleurotus ostreatus 	Pleurotacées
Plumbago de willmott 	Cerastostigma willmotianum 	Plumbaginacées
Plutée couleur de cerf 	Pluteus cervinus 	Plutéacées
Plutée couleur de lion 	Pluteus leoninus 	Pluteaceae
Plutée des saules 	Pluteus salicinus 	Plutéacées
Podagraire 	Aegopodium podagraria 	Apiacées
Pogonie langue-de-serpent 	Pogonia ophioglossoides 	Orchidacées
Poireau sauvage 	Allium polyanthum 	Alliacées
Poirier à feuilles en coeur 	Pyrus cordata 	Rosacées
Poirier commun 	Pyrus pyraster 	Rosacées
Pois élevé 	Pisum elatius 	Fabacées
Polémoine bleue 	Polemonium caeruleum 	Polémoniacées
Polycarpon de Catalogne 	Polycarpon polycarpoides ssp catalaunicum 	Caryophyllacées
Polygala à feuilles de serpolet 	Polygala serpyllifolia 	Polygalacées
Polygala des rochers 	Polygala rupestris 	Polygalacées
Polygale à feuilles de myrte 	Polygala myrtifolia 	Polygalacées
Polygale Alpestre 	Polygala alpestris 	Polygalaceae
Polygale alpine 	Polygala alpina 	Polygalaceae
Polygale commun 	Polygala vulgaris 	Polygalacées
Polygale du calcaire 	Polygala calcarea 	Polygalacées
Polygale faux-buis 	Polygala chamaebuxus 	Polygalacées
Polypode austral 	Polypodium cambricum 	Polypodiacées
Polypode intermédiaire 	Polypodium interjectum 	Polypodiacées
Polypode vulgaire 	Polypodium vulgare 	Polypodiacées
Polypogon de Montpelllier 	Polypogon monspeliensis 	Poaceae
Polypore bai 	Polyporus badius 	Polyporacées
Polypore d'hiver 	Polyporus brumalis 	Polyporacées
Polypore du bouleau 	Piptoporus betulinus 	Polyporacées
Polypore en touffes 	Grifola frondosa 	Grifolacées
Polypore géant 	Meripilus giganteus 	Meripilaceae
Polypore marginé 	Fomitopsis pinicola 	Poriacées
Polypore souffré 	Laetiporus sulfureus 	Polyporacées
Polystic à aiguillons 	Polystichum aculeatum 	Dryopteridaceae
Polystic à soies 	Polystichum setiferum 	Dryoptéridacées
Pomme rose 	Syzygium jambos 	Myrtacées
Pommier d'amour 	Solanum pseudocapsidum 	Solanacées
Pommier de Sodome 	Calotropis Procera 	Asclepiadacées
Pommier sauvage 	Malus sylvestris 	Rosacées
Pootamot crépu 	Ptamogeton crispus 	Potamogetonacées
Populage des marais 	Caltha palustris 	Renonculacées
Porcelle enracinée 	Hypochoeris radicata 	Astéracées
Porcelle glabre 	Hypochoeris glabra 	Astéracées
Poroporo 	Solanum aviculare 	Solanacée
Potamot à feuilles de Renouée 	Potamogeton polygonifolius 	Potamogetonacées
Potamot alpin 	Potamogeton alpinus 	Potamogetonaceae
Potamot graminée 	Potamogeton gramineus 	Potamogetonacées
Potamot nageant 	Potamogeton natans 	Potamogetonacées
Potamot noueux 	Potamogeton nodosus 	Potamogetonacées
Potamot perfolié 	Potamogeton perfoliatus 	Potamogetonacées
Potentille à division nombreuses 	Potentilla multifida 	Rosaceae
Potentille à nervures épaisses 	Potentilla crassinervia 	Rosacées
Potentille à tiges courtes 	Potentilla caulescens 	Rosacées
Potentille ansérine 	Potentilla anserina 	Rosacées
Potentille argentée 	Potentilla argentea 	Rosacées
Potentille cendrée 	Potentilla cinerea 	Rosaceae
Potentille de Braune 	Potentilla braumeana 	Rosacée
Potentille de Neumann 	Potentilla tabernaemontani 	Rosaceae
Potentille de norvège 	Potentilla norvegica 	Rosacées
Potentille des rochers 	Potentilla rupestris 	Rosacées
Potentille dorée 	Potentilla aurea 	Rosaceae
Potentille dressée 	Potentilla recta 	Rosacées
Potentille du Dauphiné 	Potentilla delphinensis 	Rosaceae
Potentille faux fraisier 	Potentilla sterilis 	Rosaceae
Potentille inclinée 	Potentilla inclinata 	Rosacées
Potentille printanière 	Potentilla tabernaemontani 	Rosacées
Potentille rampante 	Potentilla reptans 	Rosacées
Potentille saxifrage 	Potentilla saxifraga 	Rosaceae
Potentille tormentille 	Potentilla erecta 	Rosacées
Potentille velue 	Potentilla hirta 	Rosaceae
Pourpier de mer 	Honkenya peploides 	Caryophyllacées
Pourpier en arbre 	Portulacaria Afra 	Portulacacées
Pourpier maraîcher 	Portulaca oleracea 	Portulacacées
Prêle d'hiver 	Equisetum hyemale 	Equisétacées
Prêle des bois 	Equisetum sylvaticum 	Equisétacées
Prêle des champs 	Equisetum arvense 	Equisétacées
Prêle des eaux 	Equisetum fluviatile 	Equisetacées
Prêle des marais 	Equisetum palustre 	Equisétacées
Prêle grande 	Equisetum telmateia 	Equisétacées
Prêle ramifiée 	Equisetum ramosissimum 	Equisétacées
Prénanthe pourpre 	Prenanthes purpurea 	Astéracées
Primevère à feuilles larges 	Primula latifolia 	Primulaceae
Primevère acaule 	Primula vulgaris 	Primulacées
Primevère auriculée 	Primula auricula 	Primulacées
Primevère de Haller 	Primula halleri 	Primulacées
Primevère denticulée 	Primula denticulata 	Primulacée
Primevère élevée 	Primula elatior 	Primulacées
Primevère farineuse 	Primula farinosa 	Primulacées
Primevère hirsute 	Primula hirsuta 	Primulacées
Primevère marginée 	Primula marginata 	Primulacées
Primevère officinale 	Primula veris 	Primulacées
Prunellier 	Prunus spinosa 	Rosacées
Psathyrelle cespiteuse 	Psathyrella multipedata 	Coprinacées
Psathyrelle hydrophile 	Psathyrella piluliformis 	Coprinaceae
Pseuderanthemum atropurpureum 'Tricolor' 	Pseuderanthemum atropurpureum 	Acanthaceae
Psoralée bitumineuse 	Bituminaria bituminosa 	Fabacées
Ptychotis à feuilles variables 	Ptychotis heterophyllum 	Apiacées
Pulicaire commune 	Pulicaria vulgaris 	Astéracées
Pulicaire dysentérique 	Pulicaria dysenterica 	Astéracées
Pulmonaire des montagnes 	Pulmonaria montana 	Boraginacées
Pulmonaire officinale 	Pulmonaria officinalis 	Boraginacées
Pulmonaire semblable 	Pulmonaria affinis 	Boraginaceae
Pulsatille à lobe minces 	Pulsatilla tenuiloba 	Renonculacées
Pulsatille de Haller 	Pulsatilla halleri 	Renonculacées
Pulsatille de montagne 	Pulsatilla montana 	Renonculacées
Pulsatille des Alpes 	Pulsatilla alpina 	Renonculacées
Pulsatille printanière 	Pulsatilla vernalis 	Renonculacées
Pulsatille rouge 	Pulsatilla rubra 	Renonculacées
Pyrole à feuilles rondes 	Pyrola rotundifolia 	Ericacées
Pyrole à une fleur 	Moneses uniflora 	Pyrolacées
Pyrole moyenne 	Pyrola media 	Ericacées
Queue de lièvre 	Lagurus ovatus 	Poacées
Racine de Corail 	Corallorhiza trifida 	Orchidacées
Radiole faux-lin 	Radiola linoides 	Linacées
Raiponce à feuilles de bétoine 	Phyteuma betonicifolium 	Campanulacées
Raiponce à feuilles dentées en scie 	Phyteuma serratum 	Campanulacées
Raiponce à feuilles en coeur 	Phyteuma cordatum 	Campanulaceae
Raiponce de Haller 	Phyteuma halleri 	Campanulacées
Raiponce de Villars 	Phyteuma villarsii 	Campanulaceae
Raiponce en épi 	Phyteum spicatum 	Campanulacées
Raiponce hémisphérique 	Phyteuma hemisphaericum 	Campanulacées
Raiponce orbiculaire 	Phyteuma orbiculare 	Campanulacées
Raisin d'Amérique 	Phytolacca americana 	Phytolaccacées
Raisin d'ours 	Arctostaphylos uva-ursi 	Ericacées
Ramonde des Pyrénées 	Ramonda pyrenaica 	Geshériacées
Ravenelle 	Raphanus raphanistrum 	Brassicacées
Redoul 	Coriaria myrtifolia 	Coriariées
Réglisse sauvage 	Astragalus glycyphyllos 	Fabacées
Reichardie 	Reichardia pricroides 	Astéracées
Reine des prés 	Filipendula ulmaria 	Rosacées
Renoncule à feuilles capillaires 	Ranunculus trichophyllus 	Renonculacées
Renoncule à feuilles d'Aconit 	Ranunculus aconitifolius 	Renonculacées
Renoncule à feuilles de graminées 	Ranunculus gramineus 	Renonculacées
Renoncule à feuilles de lierre 	Ranunculus hederaceus 	Renonculacées
Renoncule à feuilles de platane 	Ranunculus platanifolius 	Ranunculaceae
Renoncule à mille feuilles 	Ranunculus millefoliatus 	Ranunculaceae
Renoncule à petites fleurs 	Ranunculus parviflorus 	Renonculacées
Renoncule à petites pointes 	Ranunculus muricatus 	Renonculacées
Renoncule à pinceau 	Ranunculus penicillatus 	Renonculacées
Renoncule âcre 	Ranunculus acris 	Renonculacées
Renoncule bulbeuse 	Ranunculus bulbosus 	Renonculacées
Renoncule de Baudot 	Ranunculus baudotii 	Renonculacées
Renoncule de Kupfer 	Ranunculus kuepferi ssp kuepferi 	Renonculacées
Renoncule de Lenormand 	Ranunculus omiophyllus 	Renonculacées
Renoncule de Revelier 	Ranunculus revelieri 	Renonculacées
Renoncule des Alpes 	Ranunculus alpestris 	Renonculacées
Renoncule des bois 	Ranunculus nemorosus 	Renonculacées
Renoncule des champs 	Ranunculus arvensis 	Renonculacées
Renoncule des glaciers 	Ranunculus glacialis 	Renonculacées
Renoncule des marais/à feuilles de cerfeuil 	Ranunculus paludosus 	Ranunculaceae
Renoncule des montagnes 	Ranunculus montanus 	Ranunculaceae
Renoncule des Pyrénées 	Ranunculus kuepferi 	Renonculacées
Renoncule laineuse 	Ranunculus lanuginosus 	Renonculacées
Renoncule peltée 	Ranunculus peltatus 	Renonculacées
Renoncule petite douve 	Ranunculus flammula 	Renonculacées
Renoncule radicante 	Ranunculus serpens 	Renunculacée
Renoncule rampante 	Ranunculus repens 	Renonculacées
Renoncule sarde 	Ranunculus sardous 	Renonculacées
Renoncule scélérate 	Ranunculus sceleratus L. 	Ranunculacées
Renoncule tête d'or 	Ranunculus auricomus 	Renonculacées
Renoncule toute blanche 	Ranunculus ololeucos 	Renonculacées
Renoncule tripartite 	Ranunculus tripartitus 	Renonculacées
Renoncule vénéneuse 	Ranunculus thora 	Renonculacées
Renouée à feuilles de patience ou d'oseille 	Persicaria lapathifolia 	Polygonacées
Renouée amphibie 	Polygonum amphibium 	Polygonacées
Renouée bistorte 	Polygonum bistorta 	Polygonacées
Renouée de l'Himalaya 	Polygonum polystachyum 	Polygonacées
Renouée de Sakhaline 	Reynoutria sachalinensis 	Polygonacées
Renouée des Alpes 	Persicaria alpina 	Polygonacées
Renouée des champs 	Polygonum aviculare subsp rurivagum 	Polygonacée
Renouée des haies 	Fallopia dumetorum 	Polygonacées
Renouée des oiseaux 	Polygonum aviculare 	Polygonacées
Renouée douce 	Persicaria mitis 	Polygonacée
Renouée du Japon 	Fallopia japonica 	Polygonaceae
Renouée liseron 	Fallopia convolvulus 	Polygonacées
Renouée maritime 	Polygonum maritimum 	Polygonacées
Renouée persicaire 	Polygonum persicaria 	Polygonacée
Renouée poivre d'eau 	Polygonum hydropiper 	Polygonacées
Renouée vivipare 	Polygonum viviparum 	Polygonacées
Réséda blanc 	Reseda alba 	Résédacées
Réséda de Jacquin 	Reseda jacquini 	Resedaceae
Réséda des Teinturiers 	Reseda luteola 	Résédacées
Réséda jaune 	Reseda lutea 	Résédacées
Réséda raiponce 	Reseda phyteuma 	Résédacées
Rhapontique des Alpes 	Rhaponticum scariosum subsp. scariosum 	Asteraceae
Rhinanthe à feuilles étroites 	Rhinanthus angustifolius 	Orobanchaceae
Rhinanthe crête-de-coq 	Rhinanthus alectorolophus 	Scrophulariacées
Rhinanthe fuie par les moutons 	Rhinanthus ovifugus 	Scrophulariaceae (Orobanchaceae)
Rhizocarpon geographicum 		
Rhododendron à clochettes 	Rhododendron yakushimanum 	ERICACEES
Rhododendron de Laponie 	Rhododendron Lapponicum 	Éricacées
Rhododendron ferrugineux 	Rhododendron ferrugineum 	Ericacées
Rhododendron Grandiflora 	Rhododendron catawbiense grandiflora 	Ericaceae
RICIN 	Ricinus communis 	Euphorbiacées
Robinier faux acacia 	Robinia pseudacacia 	Fabacées
Roemérie hybride 	Roemeria hybrida 	Papavéracées
Romarin 	Rosmarinus officinalis 	Lamiacées
Romarin d'Australie 	Westringia fruticosa 	Labiacée lamiacée
Romarin rampant ou corse 	Rosmarinus officinalis variété prostatus 	Labiées
Romulée de Colonna 	Romulea columae 	Iridaceae
Romulée de Florent 	Romulea florenti 	Iridaceae
Romulée de Provence 	Romulea bulbocodium 	Iridacées
Romulée de Rolli 	Romulea rollii 	Iridaceae
Ronce à feuilles d'orme 	Rubus ulmifolius 	Rosacées
Ronce bleuâtre 	Rubus caesius 	Rosacées
Ronce des bois 	Rubus fruticosus 	Rosacées
Ronce des rochers 	Rubus saxatilis 	Rosacées
Ronce laciniée 	Rubus laciniatus 	Rosacées
Roquette 	Eruca sativa 	Brassicaceae
Roquette jaune 	Diplotaxis tenuifolia 	Brassicacées
Rorippe amphibie 	Rorippa amphibia 	Brassicacées
Rorippe des bois 	Rorippa sylvestris 	Brassicacées
Rorippe des marais 	Rorippa palustris 	Crucifères
Rose anglaise Gertrude Jekyll 	Rosa Gertrude Jekyll 	Rosa
Rose de Bayahibe 	Pereskya quisqueyana 	Cactacées
Rosé-des-prés 	Agaricus campestris 	Agaricacées
Roseau commun 	Phragmites australis 	Poacées
Roseau de Chine géant 	Miscanthus x gigantea 	Poacées (Graminées)
Roses 	Rosa 	Rosacées
Rosier à petites fleurs 	Rosa micrantha 	Rosacées
Rosier des Alpes 	Rosa pendulina 	Rosacées
Rosier des champs 	Rosa arvensis 	Rosacées
Rosier des chiens 	Rosa canina 	Rosacées
Rosier pimprenelle 	Rosa pimpinellifolia 	Rosacées
Rosier rouillé 	Rosa rubiginosa 	Rosacées
Rosier toujours vert 	Rosa sempervirens 	Rosacées
Rossolis à feuilles rondes 	Drosera rotundifolia 	Droseracées
Rossolis à longues feuilles 	Drosera anglica 	Droseracées
Rossolis intermédiaire 	Drosera intermedia 	Droséracées
Rubanier dressé 	Sparganium erectum 	Sparganiacées
Rubanier simple 	Sparganium emersum 	Sparganiacées
Rubéole des champs 	Sherardia arvensis 	Rubiacées
Rudbeckie hérissée 	Rudbeckia hirta 	Astéracées
Rue à feuilles étroites 	Ruta angustifolia 	Rutacées
Rue des murailles 	Asplenium ruta-muraria 	Aspléniacées
Rue officinale 	Ruta Graveolens L. 	Rutacées
Rumex lunaria 	Rumex lunaria 	Polygonacées
Russule belette 	Russula mustellina 	Russulacées
Russule charbonnière 	Russula cyanoxantha 	Russulacées
Russule comestible 	Russula vesca 	Russulacées
Russule de turco 	Russula turci 	Russulacées
Russule des bouleaux 	Russula betularum 	Russulacées
Russule fausse integra 	Russula pseudo-integra 	Russulacées
Russule fétide 	Russula foetens 	Russulacées
Russule jolie 	Russula lepida 	Russulacées
Russule noircissante 	Russula nigricans 	Russulacées
Russule ocre et blanche 	Russula ochroleuca 	Russulacées
Russule pourpre et noire 	Russula krombholzii 	Russulacées
Russule rose 	Russula aurora 	Russulacées
Russule sanguine 	Russula sanguinaria 	Russulacées
Russule sardoine 	Russula drimeia 	Russulacées
Russule tardive 	Russula cessans 	Russulacées
Russule trompeuse 	Russula decipiens 	Russulacées
Russule verdoyante 	Russula virescens 	Russulacées
Russule xerampeline 	Russula xerampelina 	Russulacées
Rynchospore blanc 	Rynchospora alba 	Cypéracées
Rynchospore brun 	Rhynchospora fusca 	Cypéracées
Sabline à trois nervures 	Moerhingia trinervia 	Caryophyllacées
Sabline ciliée 	Arenaria ciliata 	Caryophyllacées
Sabline de Provence 	Gouffeia arenarioides / Arenaria provincialis 	Caryophyllaceae
Sabline des montagnes 	Arenaria montana 	Caryophyllacées
Sabline du Verdon 	Moehringia intermedia 	Caryophyllaceae
Sabline fausse moehringie 	Arenaria gothica ssp moerhingioides 	Caryophyllacées
Sabot de la vierge 	Cypripedium acaule 	Orchidacées
Sabot de Vénus 	Cypripedium calceolus 	Orchidacées
Sagine apétale 	Sagina apetala 	Caryophyllacées
Sagine couchée 	Sagina procumbens 	Caryophyllacées
Sagine poilue 	Sagina pilifera 	Caryophyllacées
Sagine subulée 	Sagina subulata 	Caryophyllacées
Sagittaire 	Sagittaria sagittifolia 	Alismatacées
Sagittaire à larges feuilles 	Sagittaria latifolia 	Alismatacées
Sainfoin 	Onobrychis viciifolia 	Fabacées
Sainfoin à dents égales 	Onobrychis aequidentata 	Fabaceae
Sainfoin buissonnant 	Hedysarum fruticosum Pallis 	Fabacées
Sainfoin d'Europe 	Hedysarum boveanum subsp. europaeum 	Fabaceae
Sainfoin de Boutigny 	Hedysarum hedysaroides usbp. boutignyanum 	Fabaceae
Sainfoin de Briançon 	Hedysarum brigantiacum 	Fabacées
Sainfoin des Alpes 	Hedysarum hedysaroies ssp hedysaroides 	Fabacées
Sainfoin des rochers 	Onobrychis saxatilis (L.) Lam 	Fabaceae
Sainfoin très épineux 	Hedysarum spinosissimum subsp. spinosissimum 	Fabaceae
Saint bois 	Daphne gnidium 	Thymelacées
Salicaire commune 	Lythrum salicaria 	Lythracées
Salsepareille 	Smilax aspera 	Smilacacées
Salsifis à feuilles de poireau 	Tragopogon porrifolius 	Astéracées
Salsifis à feuilles étroites 	Tragopogon angustifolius 	Astéracées
Salsifis des prés 	Tragopogon pratensis 	Astéracées
Salsifis douteux 	Tragopogon dubius 	Astéracées
Sanguinaire du Canada 	Sanguinaria canadensis 	Papavéracées
Sanicle d'Europe 	Sanicula europaea 	Apiacées
SANTOLINE 	SANTOLINA 	Composées
Sapin de Nordmann 	Abies nordmanniana 	Pinacées
Sapin des quatre couleurs 	Cryptomeria japonica 	TAXODIACEES
Sapin pectiné 	Abies alba 	Pinacées
Saponaire de Montpellier 	Saponaria ocymoides 	Caryophyllacées
Saponaire des vaches 	Vaccaria hispanica var. vaccaria (L.) Greuter 	Caryophyllaceae
Saponaire officinale 	Saponaria officinalis 	Caryophyllacées
Sarcodon imbriqué 	Sarcodon imbricatum 	Bankeracées
Sarracénie pourpre 	Sarracenia purpurea 	Sarracéniacées
Sarriette 	Satureja acinos 	Lamiacées
Sarriette des montagnes 	Satureja montana 	Labiées
Sarriette rose 	Satureja thymbra 	Lamiacées
Satyre puant 	Phalus impudicus 	Phallacées
Sauge à feuilles de verveine 	Salvia verbenaca 	Lamiacées
Sauge ananas 	Salvia elegans 	Sauge
Sauge d'éthiopie 	Salvia aethiopis 	Lamiacées
Sauge de Crête 	Salvia pomifera 	Lamiacées
Sauge de Jérusalem 	Phlomis fruticosa 	Lamiacées
Sauge des prés 	Salvia pratensis 	Lamiacées
Sauge glutineuse 	Salvia glutinosa 	Lamiacées
Sauge grahami 	Salvia microphylla 	Lamiacées
Sauge officinale 	Salvia officinalis 	Lamiacées
Sauge sclarée 	Salvia sclarea 	Lamiacées
Saule à feuilles émoussées 	Salix retusa 	Salicacées
Saule à grandes feuilles 	Salix appendiculata 	Salicacées
Saule à oreillettes 	Salix aurita 	Salicacées
Saule à trois étamines 	Salix trianda 	Salicacées
Saule blanc 	Salix alba 	Salicacées
Saule cassant 	Salix fragilis 	Salicacées
Saule cendré 	Salix cinerea 	Salicacées
Saule de Lagger 	Salix laggeri 	Salicacées
Saule des Pyrénées 	Salix pyrenaica 	Salicacées
Saule des vanniers 	Salix viminalis 	Salicacées
Saule drapé 	Salix elaeagnos 	Salicacées
Saule faux daphné 	Salix daphnoides 	Salicaceae
Saule fétide 	Salix foetida 	Salicacées
Saule helvétique 	Salix helvetica 	Salicacées
Saule herbacé 	Salix herbacea 	Salicacées
Saule marsault 	Salix caprea 	Salicacées
Saule pleureur 	Salix babylonica 	Salicacées
Saule pourpre 	Salix purpurea 	Salicacées
Saule rampant 	Salix repens 	Salicacées
Saule réticulé 	Salix reticulata 	Salicacées
Saule roux 	Salix atrocinerea 	Salicacées
Saussurée couchée 	Saussurea alpina 	Astéracées
Saussurée des Alpes 	Saussurea alpina ssp alpina 	Astéracées
Savonnier 	Koelreuteria paniculata 	Sapindacees
Saxaifrage à feuilles de cochlée 	Saxifraga cochlearis 	Saxifragageae
Saxifrage à deux fleurs 	Saxifraga biflora 	Saxifragacées
Saxifrage à feuilles en coin 	Saxifraga cuneifolia 	Saxifragacées
Saxifrage à feuilles opposées 	Saxifraga oppositifolia 	SAXIFRAGEES
Saxifrage à feuilles rétuses 	Saxifraga Retusa Gouan 	SAXIFRAGEES
Saxifrage à feuilles rondes 	Saxifraga rotundifolia L 	Saxifragacées
Saxifrage à fleurs abondantes 	Saxifraga florulenta 	Saxifragacées
Saxifrage à longues feuilles 	Saxifraga longifolia 	Saxifragacées
Saxifrage à trois doigts 	Saxifraga tridactylites 	Saxifragacées
Saxifrage androsace 	Saxifraga androsacea 	Saxifragacées
Saxifrage aquatique 	Saxifraga aquatica 	Saxifragacées
Saxifrage bleuâtre 	Saxifraga caesia 	Saxifragaceae
Saxifrage bouc 	Saxifraga hirculus 	Saxifragacées
Saxifrage de Séguier 	Saxifraga seguieri 	Saxifragacées
Saxifrage étoilée 	Saxifraga stellaria 	Saxifragacées
Saxifrage fausse mousse 	Saxifraga muscoides All. 	Saxifragées
Saxifrage faux aizoon 	Saxifraga Aizoides Linné 	Saxifragacées
Saxifrage faux-bryum 	Saxifraga bryoides 	Saxifragacées
Saxifrage granulée 	Saxifraga granulata 	Saxifragacées
Saxifrage musquée 	Saxifraga exarata ssp moschata 	Saxifragacée
Saxifrage paniculée 	Saxifraga paniculata 	Saxifragacées
Saxifrage rude, saxifrage rugueux 	Saxifraga aspera 	Saxifragaceae
Saxifrage sillonnée 	Saxifraga exarata 	Saxifragacées
Scabieuse à feuilles de graminée 	Lomelosia graminifolia 	Dipsacaceae
Scabieuse colombaire 	Scabiosa columbaria 	Dipsacacées
Scabieuse de Gramont 	Scabiosa triandra 	Caprifoliaceae
Scabieuse des champs 	Knautia arvensis 	Dipsacacées
Scabieuse des prés 	Scabiosa pratensis 	Caprifoliaceae
Scabieuse Maritime 	Scabiosa atropurpurea var. maritima 	Caprifoliaceae
Sceau de Salomon à feuilles verticillées 	Polygonatum verticillatum 	Liliacées
Sceau de Salomon multiflore 	Polygonatum multiflorum 	Liliacées
Sceau de Salomon odorant 	Polygonatum odoratum 	Liliacées
Schizophylle commune 	Schizophyllum commune 	Schyzophyllaceae
Scille à deux feuilles 	Scilla bifolia 	Liliacées
Scille d'automne 	Scilla autumnalis 	Hyacinthacées
Scille d'Espagne 	Hyacinthoides hispanica 	Liliacées
Scille d'Italie 	Hyacinthoides italica 	Hyacinthacées
Scille du pérou 	Oncostema peruviana 	Liliaceae
Scille lys jacinthe 	Scilla lilio-hyacinthus 	Liliacées
Scille maritime 	Drimia maritima 	Liliacées
Scille printanier 	Scilla verna 	Liliacées
Scirpe à nombreuses tiges 	Eleocharis multicaulis 	Cypéracée
Scirpe aciculaire 	Eleocharis acicularis 	Cypéracées
Scirpe des bois 	Scirpus sylvaticus 	Cypéracées
Scirpe des marais 	Eleocharis palustris 	Cypéracées
Scirpe flottant 	Scirpus fluitans 	Cyperacées
Scirpe gazonnant 	Scirpus cespitosus 	Cypéracées
Scirpe jonc 	Scirpoides holoschoenus 	Cyperaceae
Scirpe jonc des chaisiers 	Scirpus lacustris 	Cypéracées
Scirpe maritime 	Bolboschoenus maritimus 	Cypéracées
Scléroderme vulgaire 	Scleroderma citrinum 	Sclérodermatacées.
Sclérotinie tubereuse 	Dumontinia tuberosa 	Pezizomycetideae
Scolopendre 	Phyllitis scolopendrium 	Aspléniacées
Scolopendre sagitté 	Asplenium sagittatum 	Aspleniaceae
Scolyme d'Espagne 	Scolymus hispanicus 	Astéracées
Scorsonère des prés 	Scorzonera humilis 	Astéracées
Scorzonère basse 	Scorzonera humilis 	Astéracées
Scorzonère d'Autriche 	Scorzonera austriaca 	Asteraceae
Scrofulaire du Jura 	Scrophularia canina susp.juratensis 	Scrophulariacées
Scrophulaire à feuilles de germandrée 	Scrophularia scorodonia 	Scrophulariacées
Scrophulaire à trois folioles 	Scrophularia trifoliata 	Scrophulariaceae
Scrophulaire aquatique 	Scrophularia auriculata 	Scrophulariacées
Scrophulaire des chiens 	Scrophularia canina subsp. canina 	Scrophulariaceae
Scrophulaire noueuse 	Scrophularia nodosa 	Scrophulariacées
Scutellaire à casque 	Scutellaria galericulata 	Labiées
Scutellaire des Alpes 	Scutellaria alpina 	Labiées
Sécurigère en forme de hachette 	Securigera securidaca 	Fabacées
Sedum du littoral 	Sedum litoreum 	Crassulacées
Sellaginelle denticulée 	Sellaginella denticulata 	Sellaginellacées
Séné 	Cassia italica 	Fabacées
Sénebière didyme 	Coronopus didymus 	Cruciféracées
Seneçon à feuille d'adonis 	Jacobaea adonidifolia 	Asteraceae
Séneçon à feuilles blanches 	Senecio leucophyllus 	Asteracées
Séneçon à feuilles de roquette 	Senecio erucifolius 	Astéracées
Séneçon à feuilles grasses 	Senecio leucanthemifolius 	Astéracées
Seneçon anguleux 	Senecio angulatus 	Asteraceae
Séneçon aquatique 	Senecio aquaticus 	Astéracées
Séneçon blanchâtre 	Senecio incanus 	Astéracées
Séneçon commun 	Senecio vulgaris 	Astéracées
Séneçon de Fuchs 	Senecio fuchsii 	Astéracées
Seneçon de Persoon 	Jacobaea persoonii 	Asteraceae
Séneçon de printemps 	Senecio vernalis 	Asteraceae
Séneçon des Alpes 	Senecio alpinus 	Astéracées
Séneçon des marais 	Senecio paludosus 	Astéracées
Séneçon des Pyrénées 	Senecio pyrenaïcus 	Asteracées
Séneçon doria 	Senecio doria 	Astéracées
Séneçon doronic 	Senecio doronicum 	Asteracées
Séneçon du Cap 	Senecio inaequidens 	Astéracées
Séneçon en arbre 	Baccharis halimifolia 	Astéracées
Séneçon heritieri 	Senecio heritieri 	Asteracées
Séneçon Jacobée 	Senecio jacobaea 	Astéracées
Séneçon livide 	Senecio lividus 	Asteraceae
Séneçon visqueux 	Senecio viscosus 	Asteraceae
Senna ou cassia 	Senna pendula 	Fabacées
Sensitive Géante 	Catclaw Mimosa 	Légumineuses
Sequoia géant 	Sequoiadendron giganteum 	Cupressacées
Sequoia toujours vert 	Sequoia sempervirens 	Taxodiacées
Serapias à fleurs raides 	Serapias strictiflora 	Orchidaceae
Serapias à labelle en soc de charrue 	Serapias vomeracea 	Orchidaceae
Sérapias à petites fleurs 	Serapias parviflora 	Orchidacées
Serapias d'Hyères 	Serapias olbia 	Orchidacées
Serapias en coeur 	Serapias cordigera 	Orchidaceae
Sérapias langue 	Serapia lingua 	Orchidacées
Serapias negligé 	Serapias neglecta 	Orchidacées
Seringat 	Philadelphus coronarius 	Hydrangeaceae
Sermontain 	Laserpitium siler 	Apiacées
Serpolet faux-Pouliot 	Thymus pulegioides 	Lamiacées
Serpolet précoce 	Thymus praecox 	Lamiacées
Serratule à feuilles de lycope 	Klasea lycopifolia 	Asteraceae
Serratule à gros capitules 	Serratula tinctoria subsp. monticola (Boreau) 	Asteraceae
Serratule des teinturiers 	Serratula tinctoria 	Astéracées
Séseli des montagnes 	Seseli montanum 	Apiacées
Séséli libanotis 	Seseli libanotis 	Apiacées
Seslérie bleue 	Sesleria caerulea 	Poacées
Sétaire naine 	Setaria pumila 	Poacées
Sétaire verte 	Setaria viridis 	Poacées
Sétaire verticillée 	Setaria verticillata 	Poacées
Sibbaldie couchée 	Sibbaldia procumbens 	Rosacées
Sibthorpie d'Europe 	Sibthorpia europaea 	Scrofulariacées
Silène à bouquets 	Silene armeria 	Caryophyllacées
Silène à feuilles en coeur 	Silene cordifolia 	Caryophylacées
Silene à fleurs scabres 	Silene scabriflora 	Caryophyllacées
Silène à oreillettes 	Silene otites 	Caryophyllacées
Silène acaule 	Silene acaulis 	Caryophyllacées
Silène behen 	Silene behen 	Caryophyllacées
Silène bifurqué 	Silene dichotoma 	Caryophyllacées
Silène conique 	Silene conica 	Caryophyllacées
Silène d'Italie 	Silene italica 	Caryophyllacées
Silène de dieux 	Silene flos-jovis 	Caryophyllacées
Silène de France 	Silene gallica 	Caryophyllacées
Silène de Thore 	Silene vulgaris ssp thorei 	Caryophyllacées
Silène des forêts 	Silene nemoralis 	Caryophyllaceae
Silène des rochers 	Silene rupestris 	Caryophyllacées
Silène dioïque 	Silene dioica 	Caryophyllacées
Silène enflé 	Silene vulgaris 	Caryophyllacées
Silene faux sédum 	Silene sedoides 	Caryphyllacées
Silène fleur de coucou 	Silene flos-coculi 	Caryophyllacées
Silène gai, silène de Corse 	Eudianthe laeta 	Caryophyllacées
Silène maritime 	Silene uniflora 	Caryophyllacées
Silène penché 	Silene nutans 	Caryophyllacées
Silene soyeux 	Silene sericea 	Caryophyllaceae
Silene succulente de Corse 	Silene succulenta subsp. corsica 	Caryophyllaceae
Siméthis de Mattiazzi 	Simethis mattiazzii 	Asphodelacées
Sison 	Sison ammonum 	Apiacées
Sisymbre d'Autriche 	Sisymbrium austriacum 	Brassicacées
Sisymbre officinal 	Sisymbrium officinale 	Brassicacées
Soldanelle des Alpes 	Soldanella alpina 	Primulacées
Solidage glabre 	Solidago glabra 	Astéracées
Solidage verge d'or 	Solidago virgaurea 	Astéracées
Sorbier des oiseleurs 	Sorbus aucuparia 	Rosacées
Sorgho commun 	Sorghum bicolor 	Poacées
Sorgho d'Alep 	Sorghum halepense 	Poacées
Souchet brun 	Cyperus fuscus 	Cypéracées
Souchet vigoureux 	Cyperus vegetus 	Cypéracées
Souci officinal 	Calendula officinalis 	Astéracées
Souci pluvial 	Osteospermum 	Astéracées
Soucis des champs 	Calendula arvensis 	Astéracées
Soude brûlée 	Salsola kali 	Chénopodiacées
Soude commune 	Salsola soda 	Chénopodiacées
Soude maritime 	Suaeda maritima 	Chénopodiacées
Spartier faux jonc 	Spartium junceum 	Fabacées
Spéculaire en faux 	Legousia falcata 	Campanulacées
Spergulaire rouge 	Spergularia rubra 	Caryophyllacées
Spergule des champs 	Spergula arvensis 	Caryophyllacées
Spinelle fusiger 	Spinellus fusiger 	Muccoracées
Spiranthe d'automne 	Spiranthes spiralis 	Orchidacées
Spiranthe d'été 	Spiranthes aestivalis 	Orchidacées
Spirée blanche 	Spiraea alba 	Rosacées
Stachis sylvatica 	Stachys 	Lamiacée
Stapelia Varietaga 	Stapelia varietaga 	Stapéliées
Statice à feuilles en coeur 	Limonium cordatum 	Plumbaginacées
Statice commun 	Limonium vulgare 	Plumbaginacées
Statice de Girard 	Limonium girardianum 	Plumbaginaceae
Statice fausse vipérine 	Limonium echioides 	Plumbaginaceae
Stellaire des bois 	Stellaria nemorum 	Caryophyllacées
Stellaire des fanges 	Stellaria Alsine 	Caryophyllacées
Stellaire des marais 	Stellaria palustris 	Caryophyllacées
Stellaire des montagnes 	Stellaria nemorum subsp. montana (Pierrat) Berher, 1887 	Caryophyllaceae
Stellaire graminée 	Stellaria Graminea 	Caryophyllacées
Stellaire holostée 	Stellaria holostea 	Caryophyllacées
Stellaire intermédiaire 	Stellera media 	Caryophyllacées
Stérée hirsute 	Stereum hirsutum 	Stereaceae
Stipe à feuilles pennées 	Stipa pennata 	Poacées
Stipe du Cap 	Stipa capensis 	Poacées
Streptope amplexicaule 	Streptopus amplexifolius 	Liliacées
Succise des prés 	Succisa pratensis 	Dipsacacées
Succowie des Baléares 	Succowia balearica 	Brassicacées
Sumac de Virginie 	Rhus typhina 	Anacardiacées
Sureau à grappes 	Sambuscus racemosa 	Caprifoliacées
Sureau noir 	Sambuscus nigra 	Caprifoliacées
Sureau yèble 	Sambucus ebulus 	Caprifoliacées
Suzanne aux yeux noir 	Thunbergia alata 	Acanthacées
Swertie vivace 	Swertia perennis 	Gentianacées
Symphorine 	Symphoricarpos albus 	Caprifoliacées
Tabac glauque 	Nicotiana glauca 	Solanacées
Tabouret à feuilles rondes 	Noccaea rotundifolia 	Brassicacées
Tabouret perfolié 	Kandis perfoliata 	Brassicacées
Tamarin des Hauts 	Acacia heterophylla 	Mimosaceae
Tamaris d'été 	Tamarix ramosissima 	Tamaricacées
tamier 	tamos 	gripante
Tamier commun 	Tamus communis 	Dioscoréacées
Tanaisie 	Tanacetum vulgare 	Astéracées
Tanaisie en corymbe 	Tanacetum corymbosum 	Astéracées
Tecoma du cap 	Tecoma capensis 	Bignoniaceae
Teesdalie à tiges nues 	Teesdalia nudicaulis 	Cruciféracées
Telekie élégante 	Telekia speciosa 	Astéracées
Téléphium d'Imperato 	Telephium imperati 	Molluginaceae
Téphoseris en capitule 	Tephroseris integrifolia capitata 	Astéracées
Tête de Méduse 	Taeniapterum caput-medusae 	Poacées
Thapsie velue 	Thapsia villosa 	Apiacées
Thé des bois 	Gaultheria procumbens 	Ericacées
Thésium couché 	Thesium humifusum subsp. humifusum 	Santalaceae
Thésium des Pyrénées 	Thesium pyrenaicum 	Santalacées
Thesium divariqué 	Thesium divaricatum 	Santalaceae
Thuya d'Occident 	Thuja occidentalis 	Cupressacées
Thuya d'Orient 	Thuja orientalis 	Cupressacées
Thuya géant 	Thuja plicata 	Cupressacées
Thym / Farigoule 	Thymus vulgaris 	Lamiacées
Thym alpestre 	Thymus alpestris 	Lamiaceae
Thym citron 	Thymus citriodorus 	Lamiacées
Thym commun 	Thymus vulgaris 	Lamiacées
Thym corse 	Thymus herba-barona 	Lamiacées
Thym de Carniole 	Thymus froelichianus 	Lamiacées
Thym résineux 	Thymus mastichina 	Lamiacées
Thym serpolet 	Thymus serpyllum 	Lamiacées
Thym zahtar 	Thymus capitatus 	Lamiacées
Tiarelle feuille en coeur 	Tiarella cordifolia 	Saxifragacées
Tillée mousse 	Crassula tillaea 	Crassulacées
Tilleul à grandes feuilles 	Tilia platyphyllos 	Tiliacées
Tilleul à petites feuilles 	Tilia cordata 	Tiliacées
Tofieldie à calicule 	Tofieldia calyculata 	Liliacées
Tordyle d'Apulie 	Tordylium apulum 	Apiacées
Torilis des champs 	Torilis arvensis 	Apiacées
Torilis faux-cerfeuil 	Torilis japonica 	Apiacées
Tozzie des Alpes 	Tozzia alpina 	Scrophulariacées
Trachélie bleue 	Trachelium caeruleum 	Campanulacées
Tracheophytes, Angiospermes, Monocotylédones 	Grastidium Camaridiorum 	Orchidaceae
Trèfle alpestre 	Trifolium alpestre 	Fabacées
Trèfle alpin 	Trifolium alpinum 	Fabacées
Trèfle bai 	Trifolium badium 	Fabacées
Trèfle bitumineux / Psoralée bitumineuse 	Bituminaria bituminosa / Psolarea bituminosa 	Fabacées
Trèfle champêtre 	Trifolium campestre 	Fabacées
Trèfle d'eau 	Menyanthes trifoliata 	Ményanthacées
Trèfle de Hongrie 	Trifolium pannonicum 	Fabaceae
Trèfle des champs 	Trifolium arvense 	Fabacées
Trèfle des montagnes 	Trifolium montanum 	Fabacées
Trèfle douteux 	Trifolium dubium 	Fabacées
Trèfle étoilé 	Trifolium stellatum 	Fabacées
Trèfle hérissé 	Trifolium hirtum 	Fabaceae
Trèfle hybride 	Trifolium hybridum 	Fabacées
Trèfle incarnat 	Trifolium incarnatum L 	Fabacées
Trèfle intermédiaire 	Trifolium medium 	Papilionacées
Trèfle jaune 	Trifolium aureum - Trifolium strepens 	Fabacées
Trèfle maritime 	Trifolium maritimum 	Fabacées
Trèfle noircissant 	Trifolium nigrescens 	Fabaceae
Trèfle pâlissant 	Trifolium pallescens 	Fabaceae
Trèfle porte-fraises 	Trifolium fragiferum 	Fabacées
Trèfle pourpre 	Trifolium purpureum ou Trifolium angustifolium subsp. purpureum 	Fabacées
Trèfle rampant 	Trifolium repens 	Fabacées
Trèfle renversé 	Trifolium resupinatum 	Fabacées
Trèfle rouge 	Trifolium pratense 	Fabacées
Trèfle rougeatre 	Trifolium rubens 	Fabiacées
Trèfle scabre 	Trifolium scabrum 	Fabacées
Trèfle semeur 	Trifolium subterraneum 	Fabacées
Trèfle strié 	Trifolium striatum 	Fabacées
Tremble 	Populus tremula 	Salicacées
Trémelle mésentérique 	Tremella mesenterica 	Trémellacées
Trépane barbue 	Tolpis barbata 	Astéracées
Tribule terrestre 	Tribulus terrestris 	Zygophyllacées
Tricholome à odeur de savon 	Tricholoma saponaceum 	Tricholomatacées
Tricholome de la Saint-Georges 	Calocybe gambosa 	Tricholomatacées
Tricholome disjoint 	Tricholoma sejunctum 	Tricholomatacées
Tricholome fauve 	Tricholoma fulvum 	Tricholomatacées
Tricholome prétentieux 	Tricholoma portentosum 	Tricholomatacées
Tricholome rutilant 	Tricholomopsis rutilans 	Tricholomatacées
Tricholome terreux 	Tricholoma terreum 	Tricholomatacées
Tricholome tigré 	Tricholoma pardinum 	Tricholomatacées
Trientale d'Europe,Trientalis europaea 	Trientalis europaea 	Primulacée
Trille ondulé 	Trillium undulatum 	Liliacées
Troène 	Ligustrum vulgare 	Oléacées
Trolle d'Europe 	Trollius europaeus 	Renonculacées
Trompette-des-morts 	Craterellus cornucopioides 	Cantharellacées
Truffe noire du Périgord 	Tuber melanosporum 	Tuberacées
Tsuga hétérophylle 	Tsuga heterophylla 	Pinacées
Tubaire hivernale 	Tubaria hiemalis 	Tubariaceae
Tulipe d'Agen 	Tulipa agenensis 	Liliacées
Tulipe de de l'Écluse 	Tulipa clusiana 	Liliacées
Tulipe de Guillestre 	Tulipa platistygma 	Liliacées
Tulipe sauvage 	Tulipa sylvestris 	Liliacées
Tulipier de Virginie 	Liriodendron tulipifera 	Magnoliacées
Tulostome des brumes 	Tulostoma brumale 	Agaricacées
Tunique saxifrage 	Petrorhagia saxifraga 	Caryophyllacées
Tussilage 	Tussilago farfara 	Astéracées
Urosperme de Daléchamps 	Urospermum dallechampii 	Astéracées
Utriculaire du Midi 	Utricularia australis 	Lentibulariacées
Vaillantie des murailles 	Valantia muralis 	Rubiaceae
Valériane 	Valeriana officinalis 	Valérianacées
Valériane à feuilles étroites 	Centhrantus angustifolia 	Valérianacées
Valériane des montagnes 	Valeriana montana 	Valérianacées
Valériane des Pyrénées 	Valeriana pyrenaica 	Caprifoliacées
Valériane dioïque 	Valeriana dioica 	Valerianaceae
Valériane tubéreuse 	Valeriana tuberosa 	Valerianacées
Vélar à feuilles de tanaisie 	Hugueninia tanacetifolia 	Brassicacées
Vélar provençal 	Erysemum ruscinonense 	Brassicacées
Vérâtre blanc 	Veratrum album 	Liliacées
Vérâtre noir 	Veratrum nigrum 	Mélanthiacées ex-liliacées
Verge d'or géante 	Solidago gigantea 	Astéracées
Vergerette à fleurs nombreuses 	Conyza floribunda 	Astéracées
Vergerette âcre 	Erigeron acer 	Asteraceae
Vergerette annuelle 	Erigeron annuus 	Astéracées
Vergerette de Buenos Aires 	Erigeron crispus 	Astéracées
Vergerette de Karvinski 	Erigeron karvinskianus 	Astéracées
Vergerette de l'Attique 	Erigeron atticus 	Astéracées
Vergerette de Philadelphie 	Erigeron philadelphicus 	Astéracées
Vergerette de Sumatra 	Coyza sumatrensis 	Astérascées
Vergerette des Alpes 	Erigeron alpinus 	Astéracées
Vergerette du canada 	Conyza canadensis 	Astéracées
Véronique à écusson 	Veronica scutellata 	Scrophulariacées
Véronique à feuilles d'ortie 	Veronica urticifolia 	Scrophulariacées
Véronique à feuilles de lierre 	Veronica hederifolia 	Scrophulariacées
Véronique à feuilles de serpolet 	Veronica serpyllifolia 	Scrophulariacées
Véronique à longues feuilles 	Veronica longifolia 	Scrophulariacées
Véronique à tige nue 	Veronica aphylla 	Scrophulariacées
Véronique à trois lobes 	Veronica triphyllos 	Scrophulariacées
Véronique aquatique 	Veronica anagallis-aquatica 	Scrophulariacées
Véronique buissonnante 	Veronica fruticans 	Plantaginacées
Véronique couchée 	Veronica prostrata 	Scrophulariacées
Véronique cymbalaire 	Veronica cymbalaria 	Scrophulariacées
Véronique d'Allioni 	Veronica allionii 	Scrophulariacées
Veronique d'Orsini 	Veronica austriaca subsp. dubia 	Plantaginaceae
Véronique de Buonarota 	Paederota bonarota 	Scrophulariacées
Véronique de Gouan 	Veronica ponae - Gouan 	Plantaginaceae
Véronique de perse 	Veronica persica 	Scrophulariacées
Véronique des Alpes 	Veronica alpina 	Scrophulariacées
Véronique des champs 	Veronica arvensis 	Scrophulariacées
Véronique des montagnes 	Veronica montana 	Scrophulariacées
Véronique des ruisseaux 	Veronica beccabunga 	Scrophulariacées
Véronique en épi 	Veronica spicata 	Scrophulariacées
Véronique filiforme 	Veronica filiformis 	Scrophulariacées
Véronique germandrée 	Veronica austriaca 	Scrophulariacées
Véronique ligneuse 	Veronica fruticulosa 	Scrophulariacées
Véronique luisante 	Veronica polita 	Plantaginaceae
Véronique officinale 	Veronica officinalis 	Scrophulariacées
Véronique petit-chêne 	Veronica chamaedrys 	Scrophulariacées
Véronique printannière 	Veronica verna 	Scrophulariacées
Verveine bleue 	Stachytarpheta jamaicensis 	Verbénacées
Verveine de Buenos Aires 	Verbena bonariensis 	Verbenaceae
Verveine officinale 	Verbena officinalis 	Verbénacées
Vesce à feuilles étroites 	Vicia augustifolia 	Fabaceae
Vesce à folioles étroites 	Vicia tenuifolia 	Fabaceae
Vesce à quatre graines 	Vicia tetrasperma 	Fabacées
Vesce blanchâtre 	Vicia incana (Gouan) 	Fabaceae
Vesce commune 	Vicia sativa 	Fabacées
Vesce cracca 	Vicia cracca 	Fabacées
Vesce de Bithynie 	Vicia bithynica 	Fabaceae
Vesce de Hongrie / de Pannonie 	Vicia pannonica 	Fabacées
Vesce des bois 	Vicia sylvatica 	Fabacées
Vesce des haies 	Vicia sepium 	Fabacées
Vesce des Pyrénées 	Vicia Pyrenaica 	Fabacées
Vesce du mont Cusna 	Vicia cusnae 	Fabaceae
Vesce faux sainfoin 	Viscia onobrychioides 	Fabacées
Vesce hérissée 	Vicia hirsuta 	Fabacées
Vesce hybride 	Vicia hybrida 	Fabacées
Vesce jaune 	Vicia lutea 	Fabacées
Vesce noirâtre 	Vicia melanops 	Fabacées
Vesce variable 	Vicia villosa 	Fabacées
Vesicaire 	Alyssoides utriculata 	Cruciféracées
Vesse de loup perlée 	Lycoperdon perlatum 	Lycoperdacées
Vesse-de-loup géante 	Langermannia gigantea 	Lycoperdacées
Vigne 	Vitis 	Vitacées
Violette blanche 	Viola alba 	Violacées
Violette de Jordan 	Viola jordanii Hanry, 	Violaceae
Violette de Reichenbach 	Viola reichenbachiana 	Violacées
Violette de Rivin 	Viola riviniana 	Violacées
Violette de Roquebrune/Argens 	Viola rocabrunensis 	Violacées
Violette des bois 	Viola sylvestris 	Violacées
Violette des chiens 	Viola canina 	Violacées
Violette des marais 	Viola palustris 	Violacées
Violette des Pyrénées 	Viola pyrenaica 	Violaceae
Violette des rochers 	Viola rupestris 	Violaceae
Violette hérissée 	Viola hirta 	Violaceae
Violette lactée 	Viola lactea 	Violacée
Violette ligneuse 	Viola arborescens 	Violacées
Violette odorante 	Viola odorata 	Violacées
Violettte sauvage 	Vola riviniana 	Violacées
Viorne 	Vinurnum opulus 	Caprifoliacées
Viorne à feuilles ridées 	Viburnum Rhytidophyllum 	Caprifoliacées
Viorne lantane 	Viburnum lantana 	Caprifoliacées
Viorne obier 	Viburnum opulus 	Caprifoliacées
Vipérine à calice persistant 	Echium calycinum 	Boraginacées
Vipérine à feuilles de plantain 	Echium plantagineum 	Boraginaceae
Vipérine de Crète 	Echium creticum 	Boraginacées
Viperine pustuleuse 	Echium vulgare subsp. pustulatum 	Boraginaceae
Vipérine vulgaire 	Echium vulgare 	Boraginacées
Vitex 	Vitex stahelii 	Verbenacées
Volvaire 	Hum 	Gluante
Volvaire gluante 	Volvariella gloiocephala 	Plutéacées
Vulpie queue de Rat 	Vulpia myuros 	Poacées
Vulpin des champs 	Alopecurus myosuroides 	Poacées
Vulpin des prés 	Alopecurus pratensis 	Poacées
Vulpin genouillé 	Alopecurus geniculatus 	Poacées
Vulpin roux 	Alopecurus aequalis 	Poacées
Wahlenbergie à feuilles de lierre 	Wahlenbergia hederacea 	Campanulacées
Weigelia 	Weigelia florida 	Caprifoliacées
White Zuta 	Micromeria fruticosa 	Lamiaceae
Xéranthème fermé 	Xeranthemum inapertum 	Astéracées
Xylaire du bois 	Xylaria hypoxylon 	Xylariacées
